New.CleanUp.ReferenceOTU1217	k__Bacteria; p__Actinobacteria; c__Actinobacteria; o__Actinomycetales; f__Corynebacteriaceae; g__Corynebacterium; s__	1.00	3
New.CleanUp.ReferenceOTU1216	k__Bacteria; p__Actinobacteria; c__Actinobacteria; o__Actinomycetales; f__Actinomycetaceae; g__Actinomyces; s__	1.00	3
New.CleanUp.ReferenceOTU1215	k__Bacteria; p__Actinobacteria; c__Actinobacteria; o__Actinomycetales; f__Corynebacteriaceae; g__Corynebacterium; s__	1.00	3
New.CleanUp.ReferenceOTU1213	k__Bacteria; p__Firmicutes; c__Clostridia; o__Clostridiales; f__; g__; s__	1.00	3
New.CleanUp.ReferenceOTU1212	k__Bacteria; p__Proteobacteria; c__Alphaproteobacteria; o__Sphingomonadales; f__Sphingomonadaceae; g__; s__	0.67	3
New.CleanUp.ReferenceOTU1219	k__Bacteria; p__Actinobacteria; c__Actinobacteria; o__Actinomycetales; f__Corynebacteriaceae; g__Corynebacterium; s__	0.67	3
New.CleanUp.ReferenceOTU1218	k__Bacteria; p__Firmicutes; c__Clostridia; o__Clostridiales; f__[Tissierellaceae]; g__Peptoniphilus; s__	0.67	3
New.CleanUp.ReferenceOTU422	k__Bacteria; p__Bacteroidetes; c__Bacteroidia; o__Bacteroidales; f__Porphyromonadaceae; g__Porphyromonas; s__	1.00	3
New.CleanUp.ReferenceOTU423	k__Bacteria; p__Firmicutes; c__Bacilli; o__Bacillales; f__Staphylococcaceae; g__Jeotgalicoccus; s__psychrophilus	0.67	3
New.CleanUp.ReferenceOTU1185	k__Bacteria; p__Firmicutes; c__Bacilli; o__Bacillales; f__Staphylococcaceae; g__Staphylococcus; s__	0.67	3
New.CleanUp.ReferenceOTU348	k__Bacteria; p__Proteobacteria; c__Gammaproteobacteria; o__Enterobacteriales; f__Enterobacteriaceae; g__; s__	1.00	3
New.CleanUp.ReferenceOTU1181	k__Bacteria; p__Firmicutes; c__Erysipelotrichi; o__Erysipelotrichales; f__Erysipelotrichaceae; g__Coprobacillus; s__	1.00	3
New.CleanUp.ReferenceOTU1180	k__Bacteria; p__Actinobacteria; c__Actinobacteria; o__Actinomycetales; f__Microbacteriaceae; g__Microbacterium; s__	0.67	3
New.CleanUp.ReferenceOTU424	k__Bacteria; p__Actinobacteria; c__Actinobacteria; o__Actinomycetales; f__Micrococcaceae; g__Rothia; s__dentocariosa	1.00	3
New.CleanUp.ReferenceOTU835	k__Bacteria; p__Firmicutes; c__Clostridia; o__Clostridiales; f__Lachnospiraceae; g__; s__	0.67	3
New.CleanUp.ReferenceOTU346	k__Bacteria; p__Bacteroidetes; c__Sphingobacteriia; o__Sphingobacteriales; f__Sphingobacteriaceae; g__Pedobacter; s__	0.67	3
New.CleanUp.ReferenceOTU1189	k__Bacteria; p__Firmicutes; c__Clostridia; o__Clostridiales; f__Lachnospiraceae; g__Blautia; s__	0.67	3
New.CleanUp.ReferenceOTU836	k__Bacteria; p__Firmicutes; c__Bacilli; o__Lactobacillales; f__Lactobacillaceae; g__Lactobacillus; s__	0.67	3
New.CleanUp.ReferenceOTU889	k__Bacteria; p__Fusobacteria; c__Fusobacteriia; o__Fusobacteriales; f__Fusobacteriaceae; g__Fusobacterium; s__	1.00	3
New.CleanUp.ReferenceOTU339	Unassigned	1.00	1
New.CleanUp.ReferenceOTU336	k__Bacteria; p__Proteobacteria; c__Gammaproteobacteria; o__Pasteurellales; f__Pasteurellaceae; g__; s__	0.67	3
New.CleanUp.ReferenceOTU885	k__Bacteria; p__Firmicutes; c__Clostridia; o__Clostridiales; f__[Tissierellaceae]; g__Anaerococcus; s__	1.00	3
New.CleanUp.ReferenceOTU335	k__Bacteria; p__Proteobacteria; c__Betaproteobacteria; o__Burkholderiales; f__Burkholderiaceae; g__Lautropia; s__	0.67	3
New.CleanUp.ReferenceOTU332	k__Bacteria; p__Firmicutes; c__Clostridia; o__Clostridiales; f__Ruminococcaceae; g__; s__	0.67	3
New.CleanUp.ReferenceOTU947	k__Bacteria; p__Firmicutes; c__Clostridia; o__Clostridiales; f__Veillonellaceae; g__Dialister; s__	1.00	1
New.CleanUp.ReferenceOTU1138	k__Bacteria; p__Firmicutes; c__Bacilli; o__Lactobacillales; f__Carnobacteriaceae; g__Granulicatella; s__	1.00	3
New.CleanUp.ReferenceOTU909	k__Bacteria; p__Firmicutes; c__Clostridia; o__Clostridiales; f__[Tissierellaceae]; g__WAL_1855D; s__	1.00	3
New.CleanUp.ReferenceOTU908	k__Bacteria; p__Proteobacteria; c__Betaproteobacteria; o__Burkholderiales; f__Comamonadaceae; g__; s__	1.00	3
New.CleanUp.ReferenceOTU1132	k__Bacteria; p__Proteobacteria; c__Gammaproteobacteria; o__Pseudomonadales; f__Pseudomonadaceae; g__Pseudomonas	0.67	3
New.CleanUp.ReferenceOTU1130	k__Bacteria; p__Actinobacteria; c__Actinobacteria; o__Actinomycetales; f__Propionibacteriaceae; g__Propionibacterium; s__acnes	0.67	3
New.CleanUp.ReferenceOTU1131	k__Bacteria; p__Bacteroidetes; c__Flavobacteriia; o__Flavobacteriales; f__Flavobacteriaceae; g__Capnocytophaga; s__	1.00	3
New.CleanUp.ReferenceOTU1137	k__Bacteria; p__Actinobacteria; c__Actinobacteria; o__Actinomycetales; f__Propionibacteriaceae; g__Propionibacterium	0.67	3
New.CleanUp.ReferenceOTU1134	k__Bacteria; p__Proteobacteria; c__Betaproteobacteria; o__Burkholderiales; f__Comamonadaceae; g__; s__	0.67	3
New.CleanUp.ReferenceOTU298	k__Bacteria; p__Firmicutes; c__Clostridia; o__Clostridiales; f__Ruminococcaceae; g__Ruminococcus; s__	0.67	3
New.CleanUp.ReferenceOTU838	k__Bacteria; p__Actinobacteria; c__Actinobacteria; o__Actinomycetales; f__Actinomycetaceae; g__Actinomyces; s__	1.00	3
New.CleanUp.ReferenceOTU95	k__Bacteria; p__Actinobacteria; c__Actinobacteria; o__Actinomycetales; f__Micrococcaceae; g__; s__	0.67	3
New.CleanUp.ReferenceOTU97	k__Bacteria; p__Actinobacteria; c__Actinobacteria; o__Actinomycetales; f__Propionibacteriaceae	0.67	3
New.CleanUp.ReferenceOTU10	k__Bacteria; p__Firmicutes; c__Clostridia; o__Clostridiales; f__[Tissierellaceae]; g__Anaerococcus; s__	1.00	3
New.CleanUp.ReferenceOTU12	k__Bacteria; p__Cyanobacteria; c__Chloroplast; o__Streptophyta; f__; g__; s__	1.00	3
New.CleanUp.ReferenceOTU13	k__Bacteria; p__Actinobacteria; c__Actinobacteria; o__Actinomycetales	1.00	3
New.CleanUp.ReferenceOTU15	k__Bacteria; p__Firmicutes; c__Bacilli; o__Lactobacillales; f__Streptococcaceae; g__Streptococcus; s__	1.00	3
New.CleanUp.ReferenceOTU17	k__Bacteria; p__Firmicutes; c__Bacilli; o__Bacillales; f__Staphylococcaceae; g__Staphylococcus; s__	0.67	3
New.CleanUp.ReferenceOTU18	k__Bacteria; p__Firmicutes; c__Bacilli; o__Bacillales; f__Staphylococcaceae; g__Staphylococcus; s__epidermidis	1.00	3
New.CleanUp.ReferenceOTU19	k__Bacteria; p__Proteobacteria; c__Betaproteobacteria; o__Neisseriales; f__Neisseriaceae; g__Kingella; s__	1.00	3
New.CleanUp.ReferenceOTU681	k__Bacteria; p__Proteobacteria; c__Alphaproteobacteria; o__Rhizobiales; f__; g__; s__	0.67	3
New.CleanUp.ReferenceOTU428	k__Bacteria; p__Actinobacteria; c__Actinobacteria; o__Actinomycetales; f__Corynebacteriaceae; g__Corynebacterium; s__	0.67	3
New.CleanUp.ReferenceOTU685	k__Bacteria; p__Firmicutes; c__Clostridia; o__Clostridiales; f__; g__; s__	0.67	3
New.CleanUp.ReferenceOTU63	k__Bacteria; p__Bacteroidetes; c__Flavobacteriia; o__Flavobacteriales; f__[Weeksellaceae]; g__; s__	0.67	3
New.CleanUp.ReferenceOTU834	k__Bacteria; p__Firmicutes; c__Clostridia; o__Clostridiales; f__Lachnospiraceae; g__Coprococcus; s__	1.00	3
New.CleanUp.ReferenceOTU62	k__Bacteria; p__Actinobacteria; c__Actinobacteria; o__Actinomycetales; f__Nocardioidaceae; g__; s__	0.67	3
New.CleanUp.ReferenceOTU65	k__Bacteria; p__Firmicutes; c__Bacilli; o__Bacillales; f__Staphylococcaceae; g__Staphylococcus; s__	0.67	3
New.CleanUp.ReferenceOTU64	k__Bacteria; p__Bacteroidetes; c__Bacteroidia; o__Bacteroidales; f__Prevotellaceae; g__Prevotella; s__copri	1.00	3
New.CleanUp.ReferenceOTU1083	k__Bacteria; p__Actinobacteria; c__Actinobacteria; o__Actinomycetales; f__Micrococcaceae; g__Micrococcus	0.67	3
New.CleanUp.ReferenceOTU1006	k__Bacteria; p__Bacteroidetes; c__Bacteroidia; o__Bacteroidales; f__[Paraprevotellaceae]; g__[Prevotella]; s__	0.67	3
New.CleanUp.ReferenceOTU69	k__Bacteria; p__Proteobacteria; c__Gammaproteobacteria; o__Pasteurellales; f__Pasteurellaceae; g__Haemophilus; s__	1.00	3
New.CleanUp.ReferenceOTU561	k__Bacteria; p__Proteobacteria; c__Alphaproteobacteria; o__Rickettsiales; f__mitochondria	1.00	3
New.CleanUp.ReferenceOTU1002	k__Bacteria; p__[Thermi]; c__Deinococci; o__Deinococcales; f__Deinococcaceae; g__Deinococcus; s__	1.00	3
New.CleanUp.ReferenceOTU1003	k__Bacteria; p__Firmicutes; c__Bacilli; o__Bacillales; f__Bacillaceae; g__Bacillus; s__	0.67	3
New.CleanUp.ReferenceOTU1451	k__Bacteria; p__Actinobacteria; c__Actinobacteria; o__Actinomycetales; f__Propionibacteriaceae; g__Propionibacterium; s__acnes	1.00	3
New.CleanUp.ReferenceOTU1008	k__Bacteria; p__Proteobacteria; c__Alphaproteobacteria; o__Rhodobacterales; f__Rhodobacteraceae; g__Rhodobacter; s__	1.00	3
New.CleanUp.ReferenceOTU372	k__Bacteria; p__Bacteroidetes; c__Bacteroidia; o__Bacteroidales; f__Prevotellaceae; g__Prevotella; s__	1.00	3
New.CleanUp.ReferenceOTU514	k__Bacteria; p__Actinobacteria; c__Actinobacteria; o__Actinomycetales; f__Actinomycetaceae; g__Actinomyces; s__	1.00	3
New.CleanUp.ReferenceOTU515	k__Bacteria; p__Firmicutes; c__Clostridia; o__Clostridiales; f__Ruminococcaceae; g__; s__	0.67	3
New.CleanUp.ReferenceOTU513	k__Bacteria; p__Actinobacteria; c__Actinobacteria; o__Actinomycetales; f__Actinomycetaceae; g__Actinomyces; s__	1.00	3
New.CleanUp.ReferenceOTU510	k__Bacteria; p__Actinobacteria; c__Coriobacteriia; o__Coriobacteriales; f__Coriobacteriaceae; g__Collinsella; s__aerofaciens	0.67	3
New.CleanUp.ReferenceOTU518	k__Bacteria; p__Bacteroidetes; c__Bacteroidia; o__Bacteroidales; f__Rikenellaceae; g__; s__	1.00	3
New.CleanUp.ReferenceOTU519	k__Bacteria; p__Firmicutes; c__Clostridia; o__Clostridiales; f__[Tissierellaceae]; g__Anaerococcus; s__	1.00	3
New.CleanUp.ReferenceOTU286	k__Bacteria; p__Bacteroidetes; c__Bacteroidia; o__Bacteroidales; f__Porphyromonadaceae; g__Porphyromonas; s__endodontalis	1.00	3
New.CleanUp.ReferenceOTU287	k__Bacteria; p__Proteobacteria; c__Alphaproteobacteria; o__Rhodospirillales; f__Acetobacteraceae; g__; s__	1.00	3
New.CleanUp.ReferenceOTU576	k__Bacteria; p__Bacteroidetes; c__Bacteroidia; o__Bacteroidales; f__Bacteroidaceae; g__Bacteroides; s__	0.67	3
New.CleanUp.ReferenceOTU371	k__Bacteria; p__Proteobacteria; c__Gammaproteobacteria; o__Pseudomonadales; f__Moraxellaceae; g__Moraxella; s__	1.00	3
New.CleanUp.ReferenceOTU280	Unassigned	1.00	1
New.CleanUp.ReferenceOTU87	k__Bacteria; p__Proteobacteria; c__Alphaproteobacteria; o__Rhizobiales	0.67	3
New.CleanUp.ReferenceOTU84	k__Bacteria; p__Actinobacteria; c__Actinobacteria; o__Actinomycetales; f__Micrococcaceae; g__Kocuria; s__rhizophila	1.00	3
New.CleanUp.ReferenceOTU163	k__Bacteria; p__Proteobacteria; c__Alphaproteobacteria; o__Rhizobiales; f__; g__; s__	1.00	3
New.CleanUp.ReferenceOTU288	k__Bacteria; p__Proteobacteria; c__Betaproteobacteria; o__Burkholderiales; f__Oxalobacteraceae	0.67	3
New.CleanUp.ReferenceOTU80	k__Bacteria; p__Proteobacteria; c__Betaproteobacteria; o__Neisseriales; f__Neisseriaceae; g__Neisseria; s__subflava	1.00	3
New.CleanUp.ReferenceOTU1099	k__Bacteria; p__Actinobacteria; c__Actinobacteria; o__Actinomycetales; f__Actinomycetaceae; g__Actinomyces; s__	1.00	3
New.CleanUp.ReferenceOTU1313	k__Bacteria; p__Proteobacteria; c__Betaproteobacteria; o__Burkholderiales; f__Comamonadaceae; g__Hylemonella; s__	1.00	3
New.CleanUp.ReferenceOTU887	k__Bacteria; p__Proteobacteria; c__Gammaproteobacteria; o__Pasteurellales; f__Pasteurellaceae; g__Haemophilus; s__parainfluenzae	1.00	3
New.CleanUp.ReferenceOTU925	k__Bacteria; p__Firmicutes; c__Clostridia; o__Clostridiales; f__Ruminococcaceae; g__; s__	0.67	3
New.CleanUp.ReferenceOTU1090	k__Bacteria; p__Actinobacteria; c__Actinobacteria; o__Actinomycetales; f__Micrococcaceae	1.00	3
New.CleanUp.ReferenceOTU1093	k__Bacteria; p__Firmicutes; c__Bacilli; o__Bacillales; f__Staphylococcaceae; g__Staphylococcus; s__	1.00	3
New.CleanUp.ReferenceOTU1095	k__Bacteria; p__Actinobacteria; c__Thermoleophilia; o__Solirubrobacterales; f__Solirubrobacteraceae; g__; s__	1.00	3
New.CleanUp.ReferenceOTU1094	k__Bacteria; p__Proteobacteria; c__Betaproteobacteria; o__Burkholderiales; f__Comamonadaceae	0.67	3
New.CleanUp.ReferenceOTU1097	k__Bacteria; p__Actinobacteria; c__Actinobacteria; o__Actinomycetales; f__Actinomycetaceae; g__; s__	1.00	3
New.CleanUp.ReferenceOTU1096	k__Bacteria; p__Proteobacteria; c__Alphaproteobacteria; o__Rhizobiales; f__Bradyrhizobiaceae	0.67	3
New.CleanUp.ReferenceOTU577	k__Bacteria; p__Actinobacteria; c__Actinobacteria; o__Actinomycetales; f__Actinomycetaceae; g__Actinomyces; s__	1.00	3
New.CleanUp.ReferenceOTU1258	k__Bacteria; p__Actinobacteria; c__Actinobacteria; o__Actinomycetales; f__Corynebacteriaceae; g__Corynebacterium; s__	1.00	3
New.CleanUp.ReferenceOTU303	k__Bacteria; p__Firmicutes; c__Bacilli; o__Bacillales; f__Planococcaceae; g__Sporosarcina; s__	1.00	3
New.CleanUp.ReferenceOTU260	k__Bacteria; p__Actinobacteria; c__Actinobacteria; o__Actinomycetales; f__Micrococcaceae; g__; s__	0.67	3
New.CleanUp.ReferenceOTU1252	k__Bacteria; p__Firmicutes; c__Erysipelotrichi; o__Erysipelotrichales; f__Erysipelotrichaceae; g__; s__	1.00	2
New.CleanUp.ReferenceOTU1251	k__Bacteria; p__Firmicutes; c__Clostridia; o__Clostridiales; f__Ruminococcaceae; g__; s__	1.00	3
New.CleanUp.ReferenceOTU265	k__Bacteria; p__Firmicutes; c__Bacilli; o__Gemellales; f__Gemellaceae; g__Gemella; s__	0.67	3
New.CleanUp.ReferenceOTU309	k__Bacteria; p__Actinobacteria; c__Actinobacteria; o__Actinomycetales; f__Actinomycetaceae; g__Actinomyces; s__	1.00	3
New.CleanUp.ReferenceOTU308	k__Bacteria; p__Proteobacteria; c__Gammaproteobacteria; o__Pseudomonadales; f__Moraxellaceae; g__Acinetobacter; s__	1.00	3
New.CleanUp.ReferenceOTU761	k__Bacteria; p__Actinobacteria; c__Actinobacteria; o__Actinomycetales; f__Propionibacteriaceae; g__Propionibacterium; s__acnes	1.00	3
New.CleanUp.ReferenceOTU169	k__Bacteria; p__Actinobacteria; c__Actinobacteria; o__Actinomycetales; f__Corynebacteriaceae; g__Corynebacterium; s__	0.67	3
New.CleanUp.ReferenceOTU270	k__Bacteria; p__Proteobacteria; c__Alphaproteobacteria; o__Rhizobiales; f__Methylobacteriaceae; g__Methylobacterium; s__	0.67	3
New.CleanUp.ReferenceOTU1419	k__Bacteria; p__Actinobacteria; c__Actinobacteria; o__Actinomycetales; f__Micrococcaceae; g__Rothia; s__dentocariosa	1.00	3
New.CleanUp.ReferenceOTU1418	k__Bacteria; p__Bacteroidetes; c__Flavobacteriia; o__Flavobacteriales; f__[Weeksellaceae]; g__Chryseobacterium; s__	1.00	3
New.CleanUp.ReferenceOTU767	k__Bacteria; p__Actinobacteria; c__Actinobacteria; o__Actinomycetales; f__Corynebacteriaceae; g__Corynebacterium; s__	0.67	3
New.CleanUp.ReferenceOTU769	k__Bacteria; p__Bacteroidetes; c__Bacteroidia; o__Bacteroidales; f__Prevotellaceae; g__Prevotella; s__	1.00	1
New.CleanUp.ReferenceOTU603	k__Bacteria; p__Firmicutes; c__Clostridia; o__Clostridiales; f__; g__; s__	0.67	3
New.CleanUp.ReferenceOTU1417	k__Bacteria; p__Cyanobacteria; c__Chloroplast; o__Streptophyta; f__; g__; s__	1.00	3
New.CleanUp.ReferenceOTU607	k__Bacteria; p__Actinobacteria; c__Actinobacteria; o__Actinomycetales; f__Nocardioidaceae; g__; s__	0.67	3
New.CleanUp.ReferenceOTU1413	k__Bacteria; p__Fusobacteria; c__Fusobacteriia; o__Fusobacteriales; f__Fusobacteriaceae; g__Fusobacterium; s__	1.00	3
New.CleanUp.ReferenceOTU605	k__Bacteria; p__Proteobacteria; c__Alphaproteobacteria; o__Rhodobacterales; f__Rhodobacteraceae; g__Paracoccus; s__aminovorans	0.67	3
New.CleanUp.ReferenceOTU956	k__Bacteria; p__Actinobacteria; c__Actinobacteria; o__Actinomycetales; f__Micrococcaceae	0.67	3
New.CleanUp.ReferenceOTU789	k__Bacteria; p__Firmicutes; c__Clostridia; o__Clostridiales; f__Ruminococcaceae	0.67	3
New.CleanUp.ReferenceOTU867	k__Bacteria; p__Firmicutes; c__Clostridia; o__Clostridiales; f__Ruminococcaceae; g__; s__	0.67	3
New.CleanUp.ReferenceOTU864	k__Bacteria; p__Firmicutes; c__Clostridia; o__Clostridiales; f__[Tissierellaceae]; g__Anaerococcus; s__	1.00	3
New.CleanUp.ReferenceOTU865	k__Bacteria; p__Firmicutes; c__Clostridia; o__Clostridiales; f__[Tissierellaceae]; g__Anaerococcus; s__	1.00	3
New.CleanUp.ReferenceOTU782	k__Bacteria; p__Proteobacteria; c__Alphaproteobacteria; o__Rhizobiales; f__Bradyrhizobiaceae; g__Balneimonas; s__	0.67	3
New.CleanUp.ReferenceOTU586	k__Bacteria; p__Firmicutes; c__Clostridia; o__Clostridiales; f__Lachnospiraceae; g__Dorea; s__	0.67	3
New.CleanUp.ReferenceOTU786	k__Bacteria; p__Firmicutes; c__Bacilli; o__Lactobacillales; f__Carnobacteriaceae; g__Granulicatella; s__	1.00	3
New.CleanUp.ReferenceOTU785	k__Bacteria; p__Firmicutes; c__Clostridia; o__Clostridiales; f__Ruminococcaceae; g__Ruminococcus; s__	0.67	3
New.CleanUp.ReferenceOTU784	k__Bacteria; p__Proteobacteria; c__Betaproteobacteria; o__Burkholderiales; f__Oxalobacteraceae; g__Janthinobacterium; s__	1.00	3
New.CleanUp.ReferenceOTU949	k__Bacteria; p__Actinobacteria; c__Actinobacteria; o__Actinomycetales; f__Dermabacteraceae; g__Dermabacter; s__	1.00	3
New.CleanUp.ReferenceOTU419	k__Bacteria; p__Actinobacteria; c__Actinobacteria; o__Actinomycetales; f__Corynebacteriaceae; g__Corynebacterium; s__	1.00	3
New.CleanUp.ReferenceOTU1179	k__Bacteria; p__Firmicutes; c__Clostridia; o__Clostridiales; f__; g__; s__	0.67	3
New.CleanUp.ReferenceOTU1174	k__Bacteria; p__Proteobacteria; c__Betaproteobacteria; o__Neisseriales; f__Neisseriaceae; g__Neisseria; s__cinerea	1.00	3
New.CleanUp.ReferenceOTU942	k__Bacteria; p__Firmicutes; c__Clostridia; o__Clostridiales; f__Lachnospiraceae; g__; s__	1.00	3
New.CleanUp.ReferenceOTU416	k__Bacteria; p__Firmicutes; c__Clostridia; o__Clostridiales; f__Lachnospiraceae; g__Lachnospira; s__	1.00	3
New.CleanUp.ReferenceOTU415	k__Bacteria; p__Firmicutes; c__Clostridia; o__Clostridiales; f__Ruminococcaceae; g__Faecalibacterium; s__prausnitzii	0.67	3
New.CleanUp.ReferenceOTU414	k__Bacteria; p__Firmicutes; c__Clostridia; o__Clostridiales; f__[Mogibacteriaceae]; g__; s__	1.00	2
New.CleanUp.ReferenceOTU467	k__Bacteria; p__Firmicutes; c__Clostridia; o__Clostridiales; f__[Tissierellaceae]; g__Anaerococcus; s__	1.00	3
New.CleanUp.ReferenceOTU1384	k__Bacteria; p__Actinobacteria; c__Actinobacteria; o__Actinomycetales; f__Corynebacteriaceae; g__Corynebacterium; s__	0.67	3
New.CleanUp.ReferenceOTU1386	k__Bacteria; p__Firmicutes; c__Clostridia; o__Clostridiales; f__[Tissierellaceae]; g__Finegoldia; s__	1.00	3
New.CleanUp.ReferenceOTU1381	k__Bacteria; p__Fusobacteria; c__Fusobacteriia; o__Fusobacteriales; f__Fusobacteriaceae; g__Fusobacterium; s__	1.00	3
New.CleanUp.ReferenceOTU1380	k__Bacteria; p__Actinobacteria; c__Actinobacteria; o__Actinomycetales; f__Actinomycetaceae; g__Actinomyces; s__	1.00	2
New.CleanUp.ReferenceOTU1383	k__Bacteria; p__Firmicutes; c__Bacilli; o__Bacillales	0.67	3
New.CleanUp.ReferenceOTU76	k__Bacteria; p__Bacteroidetes; c__Flavobacteriia; o__Flavobacteriales; f__[Weeksellaceae]; g__Cloacibacterium; s__	1.00	3
New.CleanUp.ReferenceOTU1389	k__Bacteria; p__Firmicutes; c__Clostridia; o__Clostridiales; f__Lachnospiraceae; g__Coprococcus; s__	0.67	3
New.CleanUp.ReferenceOTU756	k__Bacteria; p__Firmicutes; c__Clostridia; o__Clostridiales; f__Clostridiaceae; g__Clostridium; s__	0.67	3
New.CleanUp.ReferenceOTU717	k__Bacteria; p__Proteobacteria; c__Epsilonproteobacteria; o__Campylobacterales; f__Campylobacteraceae; g__Campylobacter; s__	1.00	3
New.CleanUp.ReferenceOTU632	k__Bacteria; p__Firmicutes; c__Bacilli; o__Bacillales; f__Staphylococcaceae; g__Staphylococcus; s__haemolyticus	0.67	3
New.CleanUp.ReferenceOTU1278	k__Bacteria; p__Firmicutes; c__Clostridia; o__Clostridiales	1.00	3
New.CleanUp.ReferenceOTU753	k__Bacteria; p__Cyanobacteria; c__Chloroplast; o__Streptophyta; f__; g__; s__	1.00	3
New.CleanUp.ReferenceOTU952	k__Bacteria; p__Firmicutes; c__Bacilli; o__Lactobacillales; f__Streptococcaceae; g__Streptococcus; s__	1.00	3
New.CleanUp.ReferenceOTU905	k__Bacteria; p__Firmicutes; c__Clostridia; o__Clostridiales; f__Lachnospiraceae; g__Coprococcus; s__	0.67	3
New.CleanUp.ReferenceOTU907	k__Bacteria; p__Actinobacteria; c__Actinobacteria; o__Actinomycetales; f__Corynebacteriaceae; g__Corynebacterium; s__	1.00	3
New.CleanUp.ReferenceOTU48	k__Bacteria; p__Firmicutes; c__Bacilli; o__Bacillales; f__Bacillaceae; g__Bacillus; s__	1.00	3
New.CleanUp.ReferenceOTU378	k__Bacteria; p__Bacteroidetes; c__Flavobacteriia; o__Flavobacteriales; f__Flavobacteriaceae; g__Flavobacterium; s__	0.67	3
New.CleanUp.ReferenceOTU40	k__Bacteria; p__Firmicutes; c__Clostridia; o__Clostridiales; f__Clostridiaceae; g__; s__	1.00	3
New.CleanUp.ReferenceOTU47	k__Bacteria; p__Proteobacteria; c__Gammaproteobacteria; o__Alteromonadales; f__[Chromatiaceae]; g__Rheinheimera; s__	1.00	3
New.CleanUp.ReferenceOTU45	k__Bacteria; p__Firmicutes; c__Clostridia; o__Clostridiales; f__Lachnospiraceae; g__; s__	1.00	3
New.CleanUp.ReferenceOTU903	k__Bacteria; p__Proteobacteria; c__Alphaproteobacteria; o__Sphingomonadales; f__Sphingomonadaceae; g__Sphingopyxis; s__	0.67	3
New.CleanUp.ReferenceOTU646	k__Bacteria; p__Firmicutes; c__Clostridia; o__Clostridiales; f__[Tissierellaceae]; g__Finegoldia; s__	1.00	3
New.CleanUp.ReferenceOTU620	k__Bacteria; p__Proteobacteria; c__Gammaproteobacteria; o__Enterobacteriales; f__Enterobacteriaceae	0.67	3
New.CleanUp.ReferenceOTU621	k__Bacteria; p__Firmicutes; c__Clostridia; o__Clostridiales	1.00	3
New.CleanUp.ReferenceOTU622	k__Bacteria; p__Firmicutes; c__Clostridia; o__Clostridiales; f__Ruminococcaceae; g__Ruminococcus; s__	1.00	3
New.CleanUp.ReferenceOTU664	k__Bacteria; p__Actinobacteria; c__Actinobacteria; o__Actinomycetales; f__Microbacteriaceae; g__Agrococcus; s__jenensis	1.00	3
New.CleanUp.ReferenceOTU191	k__Bacteria; p__Firmicutes; c__Bacilli; o__Lactobacillales; f__Leuconostocaceae; g__Leuconostoc; s__	0.67	3
New.CleanUp.ReferenceOTU196	k__Bacteria; p__Firmicutes; c__Bacilli; o__Lactobacillales; f__Aerococcaceae; g__Alloiococcus; s__	1.00	3
New.CleanUp.ReferenceOTU625	k__Bacteria; p__Actinobacteria; c__Actinobacteria; o__Actinomycetales; f__Dietziaceae	0.67	3
New.CleanUp.ReferenceOTU194	k__Bacteria; p__Firmicutes; c__Clostridia; o__Clostridiales; f__Veillonellaceae; g__Veillonella; s__	0.67	3
New.CleanUp.ReferenceOTU975	k__Bacteria; p__Actinobacteria; c__Actinobacteria; o__Actinomycetales; f__Propionibacteriaceae; g__Propionibacterium; s__acnes	0.67	3
New.CleanUp.ReferenceOTU1346	k__Bacteria; p__Proteobacteria; c__Betaproteobacteria; o__Rhodocyclales; f__Rhodocyclaceae; g__Hydrogenophilus; s__	0.67	3
New.CleanUp.ReferenceOTU224	k__Bacteria; p__Firmicutes; c__Clostridia; o__Clostridiales; f__Lachnospiraceae; g__; s__	1.00	3
New.CleanUp.ReferenceOTU225	k__Bacteria; p__Actinobacteria; c__Actinobacteria; o__Actinomycetales; f__Corynebacteriaceae; g__Corynebacterium; s__kroppenstedtii	0.67	3
New.CleanUp.ReferenceOTU631	k__Bacteria; p__Firmicutes; c__Clostridia; o__Clostridiales; f__[Tissierellaceae]; g__Peptoniphilus; s__	1.00	3
New.CleanUp.ReferenceOTU1427	k__Bacteria; p__Firmicutes; c__Bacilli; o__Lactobacillales; f__Lactobacillaceae; g__; s__	0.67	3
New.CleanUp.ReferenceOTU1059	k__Bacteria; p__Firmicutes; c__Clostridia; o__Clostridiales; f__; g__; s__	0.67	3
New.CleanUp.ReferenceOTU1058	k__Bacteria; p__Proteobacteria; c__Betaproteobacteria; o__Burkholderiales	0.67	3
New.CleanUp.ReferenceOTU1350	k__Bacteria; p__Firmicutes; c__Clostridia; o__Clostridiales; f__Lachnospiraceae; g__Blautia; s__	0.67	3
New.CleanUp.ReferenceOTU580	k__Bacteria; p__Actinobacteria; c__Actinobacteria; o__Actinomycetales; f__Corynebacteriaceae; g__Corynebacterium; s__	1.00	3
New.CleanUp.ReferenceOTU185	k__Bacteria; p__Firmicutes; c__Clostridia; o__Clostridiales; f__Veillonellaceae; g__Veillonella	0.67	3
New.CleanUp.ReferenceOTU1054	k__Bacteria; p__Bacteroidetes; c__Flavobacteriia; o__Flavobacteriales; f__[Weeksellaceae]; g__Elizabethkingia; s__meningoseptica	1.00	3
New.CleanUp.ReferenceOTU1057	k__Bacteria; p__Actinobacteria; c__Actinobacteria; o__Actinomycetales; f__Corynebacteriaceae; g__Corynebacterium; s__	1.00	3
New.CleanUp.ReferenceOTU638	Unassigned	1.00	1
New.CleanUp.ReferenceOTU1050	k__Bacteria; p__Firmicutes; c__Clostridia; o__Clostridiales; f__[Tissierellaceae]; g__Anaerococcus; s__	1.00	3
New.CleanUp.ReferenceOTU183	k__Bacteria; p__Firmicutes; c__Clostridia; o__Clostridiales; f__Ruminococcaceae; g__; s__	1.00	3
New.CleanUp.ReferenceOTU1052	k__Bacteria; p__Bacteroidetes; c__Flavobacteriia; o__Flavobacteriales; f__Flavobacteriaceae; g__Flavobacterium; s__	1.00	3
New.CleanUp.ReferenceOTU130	k__Bacteria; p__Proteobacteria; c__Alphaproteobacteria; o__Rhizobiales; f__Rhizobiaceae; g__Agrobacterium; s__	1.00	3
New.CleanUp.ReferenceOTU1450	k__Bacteria; p__Bacteroidetes; c__Bacteroidia; o__Bacteroidales; f__Bacteroidaceae; g__Bacteroides; s__eggerthii	0.67	3
New.CleanUp.ReferenceOTU642	k__Bacteria; p__Proteobacteria; c__Betaproteobacteria; o__Neisseriales; f__Neisseriaceae; g__Neisseria; s__subflava	1.00	3
New.CleanUp.ReferenceOTU1454	k__Bacteria; p__Actinobacteria; c__Actinobacteria; o__Actinomycetales; f__Actinomycetaceae; g__Actinomyces; s__	1.00	3
New.CleanUp.ReferenceOTU529	k__Bacteria; p__Actinobacteria; c__Acidimicrobiia; o__Acidimicrobiales; f__C111; g__; s__	1.00	1
New.CleanUp.ReferenceOTU1510	k__Bacteria; p__Fusobacteria; c__Fusobacteriia; o__Fusobacteriales; f__Leptotrichiaceae; g__Leptotrichia; s__	0.67	3
New.CleanUp.ReferenceOTU139	k__Bacteria; p__Bacteroidetes; c__Bacteroidia; o__Bacteroidales; f__Bacteroidaceae; g__Bacteroides; s__	0.67	3
New.CleanUp.ReferenceOTU1512	k__Bacteria; p__Firmicutes; c__Clostridia; o__Clostridiales; f__Lachnospiraceae; g__Lachnospira; s__	0.67	3
New.CleanUp.ReferenceOTU524	k__Bacteria; p__Bacteroidetes; c__Bacteroidia; o__Bacteroidales; f__[Paraprevotellaceae]; g__[Prevotella]; s__tannerae	1.00	3
New.CleanUp.ReferenceOTU1514	k__Bacteria; p__Firmicutes; c__Bacilli; o__Turicibacterales; f__Turicibacteraceae; g__Turicibacter; s__	0.67	3
New.CleanUp.ReferenceOTU522	k__Bacteria; p__Firmicutes; c__Bacilli; o__Bacillales; f__Bacillaceae; g__Bacillus; s__cereus	0.67	3
New.CleanUp.ReferenceOTU1516	k__Bacteria; p__Actinobacteria; c__Actinobacteria; o__Actinomycetales; f__Geodermatophilaceae; g__Geodermatophilus; s__obscurus	0.67	3
New.CleanUp.ReferenceOTU520	k__Bacteria; p__Firmicutes; c__Clostridia; o__Clostridiales; f__Veillonellaceae; g__Veillonella; s__dispar	0.67	3
New.CleanUp.ReferenceOTU480	k__Bacteria; p__Bacteroidetes; c__Bacteroidia; o__Bacteroidales; f__Bacteroidaceae; g__Bacteroides; s__	0.67	3
New.CleanUp.ReferenceOTU1027	k__Bacteria; p__Firmicutes; c__Bacilli; o__Lactobacillales; f__Aerococcaceae; g__Aerococcus; s__	0.67	3
New.CleanUp.ReferenceOTU1222	k__Bacteria; p__Proteobacteria; c__Alphaproteobacteria; o__Rhodobacterales; f__Rhodobacteraceae	1.00	3
New.CleanUp.ReferenceOTU1226	k__Bacteria; p__Firmicutes; c__Clostridia; o__Clostridiales; f__[Tissierellaceae]; g__Peptoniphilus; s__	1.00	3
New.CleanUp.ReferenceOTU778	k__Bacteria; p__Proteobacteria; c__Gammaproteobacteria; o__Pseudomonadales; f__Pseudomonadaceae; g__Pseudomonas; s__fragi	0.67	3
New.CleanUp.ReferenceOTU79	k__Bacteria; p__Firmicutes; c__Clostridia; o__Clostridiales; f__Lachnospiraceae	0.67	3
New.CleanUp.ReferenceOTU1229	k__Bacteria; p__Actinobacteria; c__Actinobacteria; o__Actinomycetales; f__Propionibacteriaceae; g__Propionibacterium; s__acnes	1.00	3
New.CleanUp.ReferenceOTU979	k__Bacteria; p__Actinobacteria; c__Actinobacteria; o__Actinomycetales; f__Micrococcaceae; g__Arthrobacter; s__psychrolactophilus	1.00	3
New.CleanUp.ReferenceOTU358	k__Bacteria; p__Proteobacteria; c__Gammaproteobacteria; o__Xanthomonadales; f__Xanthomonadaceae; g__Stenotrophomonas; s__	1.00	3
New.CleanUp.ReferenceOTU987	k__Bacteria; p__Proteobacteria; c__Alphaproteobacteria; o__Sphingomonadales; f__Sphingomonadaceae; g__Sphingobium; s__	1.00	3
New.CleanUp.ReferenceOTU1508	k__Bacteria; p__Actinobacteria; c__Actinobacteria; o__Actinomycetales; f__Micrococcaceae; g__Micrococcus	0.67	3
New.CleanUp.ReferenceOTU828	k__Bacteria; p__Firmicutes; c__Clostridia; o__Clostridiales; f__Veillonellaceae; g__Selenomonas; s__	1.00	3
New.CleanUp.ReferenceOTU982	k__Bacteria; p__Firmicutes; c__Clostridia; o__Clostridiales; f__Ruminococcaceae; g__Ruminococcus; s__	0.67	3
New.CleanUp.ReferenceOTU350	k__Bacteria; p__Firmicutes; c__Bacilli; o__Bacillales; f__[Exiguobacteraceae]; g__Exiguobacterium; s__	0.67	3
New.CleanUp.ReferenceOTU351	k__Bacteria; p__Actinobacteria; c__Actinobacteria; o__Actinomycetales; f__Propionibacteriaceae; g__Propionibacterium; s__acnes	0.67	3
New.CleanUp.ReferenceOTU824	k__Bacteria; p__Firmicutes; c__Clostridia; o__Clostridiales; f__Lachnospiraceae; g__; s__	0.67	3
New.CleanUp.ReferenceOTU354	k__Bacteria; p__Firmicutes; c__Clostridia; o__Clostridiales; f__Lachnospiraceae; g__; s__	1.00	3
New.CleanUp.ReferenceOTU355	k__Bacteria; p__Bacteroidetes; c__Flavobacteriia; o__Flavobacteriales; f__[Weeksellaceae]; g__Chryseobacterium; s__	0.67	3
New.CleanUp.ReferenceOTU356	k__Bacteria; p__Firmicutes; c__Clostridia; o__Clostridiales; f__; g__; s__	1.00	3
New.CleanUp.ReferenceOTU6	k__Bacteria; p__Firmicutes; c__Clostridia; o__Clostridiales; f__Lachnospiraceae	0.67	3
New.CleanUp.ReferenceOTU571	k__Bacteria; p__Proteobacteria; c__Gammaproteobacteria; o__Enterobacteriales; f__Enterobacteriaceae; g__Buchnera; s__	1.00	3
New.CleanUp.ReferenceOTU1430	k__Bacteria; p__Proteobacteria; c__Betaproteobacteria; o__Rhodocyclales; f__Rhodocyclaceae; g__Methyloversatilis; s__	0.67	3
New.CleanUp.ReferenceOTU730	k__Bacteria; p__Firmicutes; c__Clostridia; o__Clostridiales; f__; g__; s__	1.00	3
New.CleanUp.ReferenceOTU731	k__Bacteria; p__Actinobacteria; c__Actinobacteria; o__Actinomycetales; f__Propionibacteriaceae; g__Propionibacterium; s__acnes	0.67	3
New.CleanUp.ReferenceOTU736	k__Bacteria; p__Firmicutes; c__Clostridia; o__Clostridiales; f__; g__; s__	0.67	3
New.CleanUp.ReferenceOTU734	k__Bacteria; p__Proteobacteria; c__Betaproteobacteria; o__Neisseriales; f__Neisseriaceae	1.00	3
New.CleanUp.ReferenceOTU735	k__Bacteria; p__Firmicutes; c__Clostridia; o__Clostridiales; f__[Tissierellaceae]; g__Anaerococcus; s__	1.00	3
New.CleanUp.ReferenceOTU534	k__Bacteria; p__Fusobacteria; c__Fusobacteriia; o__Fusobacteriales; f__Leptotrichiaceae; g__Leptotrichia; s__	1.00	3
New.CleanUp.ReferenceOTU535	k__Bacteria; p__Proteobacteria; c__Alphaproteobacteria; o__Sphingomonadales; f__Sphingomonadaceae; g__Kaistobacter; s__	0.67	3
New.CleanUp.ReferenceOTU988	k__Bacteria; p__Firmicutes; c__Clostridia; o__Clostridiales	1.00	3
New.CleanUp.ReferenceOTU3	k__Bacteria; p__Actinobacteria; c__Actinobacteria; o__Actinomycetales; f__; g__; s__	0.67	3
New.CleanUp.ReferenceOTU1124	k__Bacteria; p__Firmicutes; c__Bacilli; o__Lactobacillales; f__Streptococcaceae; g__Streptococcus; s__	1.00	3
New.CleanUp.ReferenceOTU910	k__Bacteria; p__Firmicutes; c__Bacilli; o__Lactobacillales; f__Streptococcaceae; g__Streptococcus; s__luteciae	0.67	3
New.CleanUp.ReferenceOTU1120	k__Bacteria; p__TM7; c__TM7-3; o__; f__; g__; s__	1.00	3
New.CleanUp.ReferenceOTU914	k__Bacteria; p__Actinobacteria; c__Actinobacteria; o__Actinomycetales; f__Propionibacteriaceae; g__Propionibacterium; s__acnes	1.00	3
New.CleanUp.ReferenceOTU915	k__Bacteria; p__Actinobacteria; c__Actinobacteria; o__Actinomycetales; f__Corynebacteriaceae; g__Corynebacterium; s__	1.00	3
New.CleanUp.ReferenceOTU530	k__Bacteria; p__Cyanobacteria; c__Chloroplast; o__Streptophyta; f__; g__; s__	1.00	3
New.CleanUp.ReferenceOTU851	k__Bacteria; p__Firmicutes; c__Clostridia; o__Clostridiales; f__Clostridiaceae; g__; s__	0.67	3
New.CleanUp.ReferenceOTU1	k__Bacteria; p__Firmicutes; c__Clostridia; o__Clostridiales; f__Veillonellaceae; g__Dialister; s__	1.00	3
New.CleanUp.ReferenceOTU857	k__Bacteria; p__Actinobacteria; c__MB-A2-108; o__0319-7L14; f__; g__; s__	1.00	3
New.CleanUp.ReferenceOTU1128	k__Bacteria; p__Proteobacteria; c__Gammaproteobacteria; o__Pasteurellales; f__Pasteurellaceae; g__Actinobacillus; s__parahaemolyticus	1.00	3
New.CleanUp.ReferenceOTU854	k__Bacteria; p__Firmicutes; c__Bacilli; o__Lactobacillales; f__Streptococcaceae; g__Streptococcus; s__	1.00	3
New.CleanUp.ReferenceOTU533	k__Bacteria; p__Firmicutes; c__Clostridia; o__Clostridiales; f__Veillonellaceae; g__Selenomonas; s__	1.00	3
New.CleanUp.ReferenceOTU639	k__Bacteria; p__Actinobacteria; c__Actinobacteria; o__Actinomycetales; f__Brevibacteriaceae; g__Brevibacterium; s__	1.00	3
New.CleanUp.ReferenceOTU672	k__Bacteria; p__Firmicutes; c__Clostridia; o__Clostridiales; f__Lachnospiraceae; g__; s__	0.67	3
New.CleanUp.ReferenceOTU803	k__Bacteria; p__Actinobacteria; c__Actinobacteria; o__Actinomycetales; f__Actinomycetaceae; g__Actinomyces; s__	1.00	3
New.CleanUp.ReferenceOTU9	k__Bacteria; p__Firmicutes; c__Bacilli; o__Lactobacillales; f__Streptococcaceae; g__Streptococcus; s__	1.00	3
New.CleanUp.ReferenceOTU1011	k__Bacteria; p__Proteobacteria; c__Alphaproteobacteria; o__Rhodospirillales; f__Acetobacteraceae; g__Roseomonas; s__mucosa	0.67	3
New.CleanUp.ReferenceOTU1010	k__Bacteria; p__Proteobacteria; c__Gammaproteobacteria; o__Enterobacteriales; f__Enterobacteriaceae; g__Pantoea	0.67	3
New.CleanUp.ReferenceOTU1337	k__Bacteria; p__Proteobacteria; c__Betaproteobacteria; o__Neisseriales; f__Neisseriaceae; g__Conchiformibius; s__	0.67	3
New.CleanUp.ReferenceOTU1014	k__Bacteria; p__Proteobacteria; c__Alphaproteobacteria; o__Rhizobiales; f__Methylobacteriaceae; g__Methylobacterium; s__adhaesivum	0.67	3
New.CleanUp.ReferenceOTU0	k__Bacteria; p__Proteobacteria; c__Gammaproteobacteria; o__Xanthomonadales; f__Xanthomonadaceae; g__Stenotrophomonas	0.67	3
New.CleanUp.ReferenceOTU1016	k__Bacteria; p__Bacteroidetes; c__Flavobacteriia; o__Flavobacteriales; f__Flavobacteriaceae; g__Flavobacterium; s__	0.67	3
New.CleanUp.ReferenceOTU578	k__Bacteria; p__Fusobacteria; c__Fusobacteriia; o__Fusobacteriales; f__Fusobacteriaceae; g__Fusobacterium; s__	1.00	3
New.CleanUp.ReferenceOTU1018	k__Bacteria; p__Bacteroidetes; c__Cytophagia; o__Cytophagales; f__Cytophagaceae; g__Hymenobacter; s__	1.00	3
New.CleanUp.ReferenceOTU8	k__Bacteria; p__Actinobacteria; c__Actinobacteria; o__Actinomycetales; f__Actinomycetaceae; g__Actinomyces; s__	1.00	3
New.CleanUp.ReferenceOTU742	k__Bacteria; p__Firmicutes; c__Bacilli; o__Lactobacillales; f__Streptococcaceae; g__Streptococcus; s__	1.00	3
New.CleanUp.ReferenceOTU70	k__Bacteria; p__Firmicutes; c__Clostridia; o__Clostridiales; f__[Tissierellaceae]; g__Peptoniphilus; s__	1.00	3
New.CleanUp.ReferenceOTU178	k__Bacteria; p__Firmicutes; c__Clostridia; o__Clostridiales; f__Lachnospiraceae; g__[Ruminococcus]; s__	0.67	3
New.CleanUp.ReferenceOTU77	k__Bacteria; p__Proteobacteria; c__Gammaproteobacteria; o__Enterobacteriales; f__Enterobacteriaceae; g__; s__	0.67	3
New.CleanUp.ReferenceOTU75	k__Bacteria; p__Firmicutes; c__Clostridia; o__Clostridiales; f__Veillonellaceae; g__Veillonella; s__	0.67	3
New.CleanUp.ReferenceOTU175	k__Bacteria; p__Proteobacteria; c__Alphaproteobacteria; o__Rickettsiales; f__Holosporaceae; g__; s__	1.00	1
New.CleanUp.ReferenceOTU78	k__Bacteria; p__Bacteroidetes; c__Bacteroidia; o__Bacteroidales; f__[Paraprevotellaceae]; g__[Prevotella]; s__	1.00	3
New.CleanUp.ReferenceOTU177	k__Bacteria; p__Firmicutes; c__Bacilli; o__Bacillales; f__Planococcaceae; g__Sporosarcina; s__	0.67	3
New.CleanUp.ReferenceOTU170	k__Bacteria; p__Actinobacteria; c__Coriobacteriia; o__Coriobacteriales; f__Coriobacteriaceae; g__Atopobium	1.00	2
New.CleanUp.ReferenceOTU172	k__Bacteria; p__Fusobacteria; c__Fusobacteriia; o__Fusobacteriales; f__Fusobacteriaceae; g__Fusobacterium; s__	1.00	3
New.CleanUp.ReferenceOTU1065	k__Bacteria; p__Bacteroidetes; c__Sphingobacteriia; o__Sphingobacteriales; f__Sphingobacteriaceae; g__Pedobacter; s__	1.00	3
New.CleanUp.ReferenceOTU1066	k__Bacteria; p__Proteobacteria; c__Alphaproteobacteria; o__Sphingomonadales; f__Sphingomonadaceae; g__Sphingomonas; s__	0.67	3
New.CleanUp.ReferenceOTU1067	k__Bacteria; p__Bacteroidetes; c__Bacteroidia; o__Bacteroidales; f__Bacteroidaceae; g__Bacteroides; s__	1.00	3
New.CleanUp.ReferenceOTU1060	k__Bacteria; p__Firmicutes; c__Clostridia; o__Clostridiales; f__; g__; s__	1.00	3
New.CleanUp.ReferenceOTU1061	k__Bacteria; p__Firmicutes; c__Clostridia; o__Clostridiales; f__Ruminococcaceae; g__; s__	0.67	3
New.CleanUp.ReferenceOTU1063	k__Bacteria; p__Firmicutes; c__Bacilli; o__Lactobacillales; f__Streptococcaceae; g__Streptococcus; s__	1.00	3
New.CleanUp.ReferenceOTU1068	k__Bacteria; p__Firmicutes; c__Clostridia; o__Clostridiales; f__Ruminococcaceae; g__Oscillospira; s__	0.67	3
New.CleanUp.ReferenceOTU1266	k__Bacteria; p__Actinobacteria; c__Thermoleophilia; o__Solirubrobacterales; f__; g__; s__	1.00	3
New.CleanUp.ReferenceOTU316	k__Bacteria; p__Bacteroidetes; c__Flavobacteriia; o__Flavobacteriales; f__[Weeksellaceae]; g__Chryseobacterium; s__	0.67	3
New.CleanUp.ReferenceOTU1262	k__Bacteria; p__Firmicutes; c__Clostridia; o__Clostridiales; f__[Tissierellaceae]; g__Peptoniphilus; s__	1.00	3
New.CleanUp.ReferenceOTU1263	k__Bacteria; p__Firmicutes; c__Clostridia; o__Clostridiales; f__Lachnospiraceae; g__Blautia; s__	0.67	3
New.CleanUp.ReferenceOTU312	k__Bacteria; p__Bacteroidetes; c__Bacteroidia; o__Bacteroidales; f__Bacteroidaceae; g__Bacteroides; s__	0.67	3
New.CleanUp.ReferenceOTU704	k__Bacteria; p__Firmicutes; c__Clostridia; o__Clostridiales; f__Clostridiaceae; g__Clostridium; s__	0.67	3
New.CleanUp.ReferenceOTU255	k__Bacteria; p__Gemmatimonadetes; c__Gemmatimonadetes; o__Gemmatimonadales; f__Ellin5301; g__; s__	1.00	3
New.CleanUp.ReferenceOTU254	k__Bacteria; p__Actinobacteria; c__Actinobacteria; o__Actinomycetales; f__Micrococcaceae; g__; s__	0.67	3
New.CleanUp.ReferenceOTU709	k__Bacteria; p__Firmicutes; c__Clostridia; o__Clostridiales; f__Lachnospiraceae; g__Oribacterium; s__	1.00	3
New.CleanUp.ReferenceOTU256	k__Bacteria; p__Actinobacteria; c__Actinobacteria; o__Actinomycetales; f__Nocardioidaceae; g__; s__	1.00	3
New.CleanUp.ReferenceOTU1301	k__Bacteria; p__Firmicutes; c__Bacilli; o__Lactobacillales; f__Streptococcaceae; g__Streptococcus; s__	1.00	3
New.CleanUp.ReferenceOTU319	k__Bacteria; p__Bacteroidetes; c__Bacteroidia; o__Bacteroidales; f__Prevotellaceae; g__Prevotella; s__melaninogenica	0.67	3
New.CleanUp.ReferenceOTU1268	k__Bacteria; p__Actinobacteria; c__Actinobacteria; o__Actinomycetales; f__Corynebacteriaceae; g__Corynebacterium; s__	0.67	3
New.CleanUp.ReferenceOTU252	k__Bacteria; p__Cyanobacteria; c__Chloroplast; o__Streptophyta; f__; g__; s__	1.00	3
New.CleanUp.ReferenceOTU1468	k__Bacteria; p__Actinobacteria; c__Actinobacteria; o__Actinomycetales; f__Microbacteriaceae; g__Microbacterium; s__	0.67	3
New.CleanUp.ReferenceOTU774	k__Bacteria; p__Firmicutes; c__Clostridia; o__Clostridiales; f__Lachnospiraceae; g__; s__	0.67	3
New.CleanUp.ReferenceOTU775	k__Bacteria; p__Bacteroidetes; c__Bacteroidia; o__Bacteroidales; f__Prevotellaceae; g__Prevotella; s__melaninogenica	1.00	3
New.CleanUp.ReferenceOTU679	k__Bacteria; p__Firmicutes; c__Clostridia; o__Clostridiales; f__Lachnospiraceae; g__; s__	1.00	3
New.CleanUp.ReferenceOTU678	k__Bacteria; p__Actinobacteria; c__Actinobacteria; o__Actinomycetales; f__Nocardioidaceae; g__; s__	1.00	3
New.CleanUp.ReferenceOTU1460	k__Bacteria; p__Bacteroidetes; c__Cytophagia; o__Cytophagales; f__Cytophagaceae; g__Hymenobacter; s__	1.00	3
New.CleanUp.ReferenceOTU676	k__Bacteria; p__Actinobacteria; c__Actinobacteria; o__Actinomycetales; f__Corynebacteriaceae; g__Corynebacterium; s__	0.67	3
New.CleanUp.ReferenceOTU674	k__Bacteria; p__Firmicutes; c__Bacilli; o__Lactobacillales; f__Streptococcaceae; g__Streptococcus; s__	1.00	3
New.CleanUp.ReferenceOTU1465	k__Bacteria; p__Proteobacteria; c__Alphaproteobacteria; o__Caulobacterales; f__Caulobacteraceae; g__Phenylobacterium; s__	0.67	3
New.CleanUp.ReferenceOTU1466	k__Bacteria; p__Bacteroidetes; c__Bacteroidia; o__Bacteroidales; f__Porphyromonadaceae; g__Porphyromonas; s__	1.00	3
New.CleanUp.ReferenceOTU779	k__Bacteria; p__Firmicutes; c__Bacilli; o__Gemellales; f__Gemellaceae	0.67	3
New.CleanUp.ReferenceOTU387	k__Bacteria; p__Actinobacteria; c__Coriobacteriia; o__Coriobacteriales; f__Coriobacteriaceae; g__Slackia; s__	1.00	3
New.CleanUp.ReferenceOTU440	k__Bacteria; p__Actinobacteria; c__Actinobacteria; o__Actinomycetales; f__Micrococcaceae; g__; s__	1.00	3
New.CleanUp.ReferenceOTU385	k__Bacteria; p__Proteobacteria; c__Gammaproteobacteria; o__Pseudomonadales; f__Moraxellaceae; g__Enhydrobacter; s__	0.67	3
New.CleanUp.ReferenceOTU648	k__Bacteria; p__Actinobacteria; c__Coriobacteriia; o__Coriobacteriales; f__Coriobacteriaceae; g__Atopobium; s__	1.00	3
New.CleanUp.ReferenceOTU799	k__Bacteria; p__Firmicutes; c__Bacilli; o__Lactobacillales; f__Leuconostocaceae; g__Weissella; s__	0.67	3
New.CleanUp.ReferenceOTU815	k__Bacteria; p__Actinobacteria; c__Actinobacteria; o__Actinomycetales; f__Nocardiaceae; g__Rhodococcus; s__fascians	1.00	3
New.CleanUp.ReferenceOTU811	k__Bacteria; p__Firmicutes; c__Bacilli; o__Lactobacillales; f__Lactobacillaceae; g__Lactobacillus; s__	1.00	3
New.CleanUp.ReferenceOTU765	k__Bacteria; p__Actinobacteria; c__Actinobacteria; o__Actinomycetales; f__Corynebacteriaceae; g__Corynebacterium; s__	1.00	3
New.CleanUp.ReferenceOTU791	k__Bacteria; p__Proteobacteria; c__Betaproteobacteria; o__Neisseriales; f__Neisseriaceae; g__; s__	0.67	3
New.CleanUp.ReferenceOTU793	k__Bacteria; p__Bacteroidetes; c__Bacteroidia; o__Bacteroidales; f__Porphyromonadaceae; g__Porphyromonas; s__	1.00	3
New.CleanUp.ReferenceOTU795	Unassigned	1.00	1
New.CleanUp.ReferenceOTU819	k__Bacteria; p__Proteobacteria; c__Gammaproteobacteria; o__Pseudomonadales; f__Moraxellaceae; g__Acinetobacter; s__	0.67	3
New.CleanUp.ReferenceOTU797	k__Bacteria; p__Firmicutes; c__Clostridia; o__Clostridiales; f__Ruminococcaceae; g__; s__	0.67	3
New.CleanUp.ReferenceOTU1168	k__Bacteria; p__Firmicutes; c__Bacilli; o__Lactobacillales; f__Enterococcaceae	0.67	3
New.CleanUp.ReferenceOTU891	k__Bacteria; p__Proteobacteria; c__Alphaproteobacteria; o__Sphingomonadales; f__Sphingomonadaceae; g__Novosphingobium; s__	1.00	3
New.CleanUp.ReferenceOTU1161	k__Bacteria; p__Actinobacteria; c__Actinobacteria; o__Actinomycetales; f__Corynebacteriaceae; g__Corynebacterium; s__	0.67	3
New.CleanUp.ReferenceOTU401	k__Bacteria; p__Firmicutes; c__Clostridia; o__Clostridiales; f__Lachnospiraceae; g__; s__	1.00	3
New.CleanUp.ReferenceOTU1163	k__Bacteria; p__Firmicutes; c__Clostridia; o__Clostridiales; f__Ruminococcaceae; g__; s__	0.67	3
New.CleanUp.ReferenceOTU403	k__Bacteria; p__Proteobacteria; c__Gammaproteobacteria; o__Pasteurellales; f__Pasteurellaceae; g__Haemophilus; s__parainfluenzae	1.00	3
New.CleanUp.ReferenceOTU1165	k__Bacteria; p__Firmicutes; c__Clostridia; o__Clostridiales; f__Lachnospiraceae; g__Blautia; s__	1.00	3
New.CleanUp.ReferenceOTU950	k__Bacteria; p__Firmicutes; c__Bacilli; o__Bacillales; f__Staphylococcaceae; g__Staphylococcus; s__	0.67	3
New.CleanUp.ReferenceOTU951	k__Bacteria; p__Actinobacteria; c__Actinobacteria; o__Actinomycetales; f__Micrococcaceae; g__Rothia; s__aeria	0.67	3
New.CleanUp.ReferenceOTU493	k__Bacteria; p__Proteobacteria; c__Gammaproteobacteria; o__Aeromonadales; f__Aeromonadaceae; g__; s__	0.67	3
New.CleanUp.ReferenceOTU491	k__Bacteria; p__Firmicutes; c__Bacilli; o__Lactobacillales; f__; g__; s__	1.00	3
New.CleanUp.ReferenceOTU490	k__Bacteria; p__Actinobacteria; c__Actinobacteria; o__Actinomycetales; f__Propionibacteriaceae; g__Propionibacterium; s__acnes	1.00	3
New.CleanUp.ReferenceOTU699	k__Bacteria; p__Firmicutes; c__Bacilli; o__Bacillales; f__Staphylococcaceae; g__Staphylococcus; s__aureus	0.67	3
New.CleanUp.ReferenceOTU496	k__Bacteria; p__Firmicutes; c__Bacilli; o__Bacillales; f__Staphylococcaceae; g__Staphylococcus; s__	1.00	3
New.CleanUp.ReferenceOTU1230	k__Bacteria; p__Proteobacteria; c__Betaproteobacteria; o__Burkholderiales; f__Oxalobacteraceae; g__; s__	0.67	3
New.CleanUp.ReferenceOTU970	k__Bacteria; p__Actinobacteria; c__Actinobacteria; o__Actinomycetales; f__Corynebacteriaceae; g__Corynebacterium; s__	0.67	3
New.CleanUp.ReferenceOTU929	Unassigned	1.00	1
New.CleanUp.ReferenceOTU1119	k__Bacteria; p__Actinobacteria; c__Actinobacteria; o__Actinomycetales; f__Actinomycetaceae; g__Actinomyces; s__	1.00	3
New.CleanUp.ReferenceOTU1114	k__Bacteria; p__Actinobacteria; c__Actinobacteria; o__Actinomycetales; f__Corynebacteriaceae; g__Corynebacterium; s__	1.00	3
New.CleanUp.ReferenceOTU1115	k__Bacteria; p__Firmicutes; c__Clostridia; o__Clostridiales; f__[Tissierellaceae]; g__Finegoldia; s__	1.00	3
New.CleanUp.ReferenceOTU1116	k__Bacteria; p__Actinobacteria; c__Actinobacteria; o__Actinomycetales; f__Actinomycetaceae; g__Actinomyces; s__	1.00	3
New.CleanUp.ReferenceOTU927	k__Bacteria; p__Firmicutes; c__Clostridia; o__Clostridiales; f__Lachnospiraceae; g__; s__	0.67	3
New.CleanUp.ReferenceOTU926	k__Bacteria; p__Firmicutes; c__Clostridia; o__Clostridiales; f__[Tissierellaceae]; g__Peptoniphilus; s__	1.00	3
New.CleanUp.ReferenceOTU1112	k__Bacteria; p__Bacteroidetes; c__Bacteroidia; o__Bacteroidales; f__Prevotellaceae; g__Prevotella; s__	1.00	3
New.CleanUp.ReferenceOTU1113	k__Bacteria; p__Firmicutes; c__Clostridia; o__Clostridiales; f__[Tissierellaceae]; g__Anaerococcus; s__	1.00	3
New.CleanUp.ReferenceOTU906	k__Bacteria; p__Actinobacteria; c__Actinobacteria; o__Actinomycetales; f__Corynebacteriaceae; g__Corynebacterium; s__	1.00	3
New.CleanUp.ReferenceOTU943	k__Bacteria; p__Firmicutes; c__Clostridia; o__Clostridiales; f__[Tissierellaceae]; g__Anaerococcus; s__	1.00	3
New.CleanUp.ReferenceOTU703	k__Bacteria; p__Firmicutes; c__Clostridia; o__Clostridiales	1.00	3
New.CleanUp.ReferenceOTU1288	k__Bacteria; p__Firmicutes; c__Bacilli; o__Lactobacillales; f__Streptococcaceae; g__Streptococcus; s__	0.67	3
New.CleanUp.ReferenceOTU1289	k__Bacteria; p__Proteobacteria; c__Gammaproteobacteria; o__Pseudomonadales; f__Pseudomonadaceae; g__Pseudomonas; s__	1.00	3
New.CleanUp.ReferenceOTU1285	k__Bacteria; p__Firmicutes; c__Bacilli; o__Bacillales; f__[Exiguobacteraceae]; g__Exiguobacterium; s__	1.00	3
New.CleanUp.ReferenceOTU1287	k__Bacteria; p__Bacteroidetes; c__Bacteroidia; o__Bacteroidales; f__Porphyromonadaceae; g__Porphyromonas; s__	1.00	3
New.CleanUp.ReferenceOTU1280	k__Bacteria; p__Firmicutes; c__Clostridia; o__Clostridiales; f__Ruminococcaceae; g__Ruminococcus; s__	1.00	3
New.CleanUp.ReferenceOTU1281	k__Bacteria; p__Firmicutes; c__Clostridia; o__Clostridiales; f__[Tissierellaceae]; g__ph2; s__	1.00	3
New.CleanUp.ReferenceOTU706	k__Bacteria; p__Proteobacteria; c__Gammaproteobacteria; o__Xanthomonadales; f__Xanthomonadaceae	0.67	3
New.CleanUp.ReferenceOTU705	k__Bacteria; p__Firmicutes; c__Clostridia; o__Clostridiales; f__Veillonellaceae; g__Veillonella; s__dispar	1.00	3
New.CleanUp.ReferenceOTU38	k__Bacteria; p__Firmicutes; c__Clostridia; o__Clostridiales; f__Veillonellaceae; g__Dialister; s__	1.00	3
New.CleanUp.ReferenceOTU32	k__Bacteria; p__Actinobacteria; c__Actinobacteria; o__Actinomycetales; f__Corynebacteriaceae; g__Corynebacterium; s__	1.00	3
New.CleanUp.ReferenceOTU30	k__Bacteria; p__Firmicutes; c__Clostridia; o__Clostridiales	1.00	3
New.CleanUp.ReferenceOTU31	k__Bacteria; p__Actinobacteria; c__Coriobacteriia; o__Coriobacteriales; f__Coriobacteriaceae; g__Collinsella; s__aerofaciens	0.67	3
New.CleanUp.ReferenceOTU449	k__Bacteria; p__Bacteroidetes; c__Bacteroidia; o__Bacteroidales; f__Porphyromonadaceae; g__Porphyromonas; s__	1.00	3
New.CleanUp.ReferenceOTU1300	k__Bacteria; p__Actinobacteria; c__Actinobacteria; o__Actinomycetales; f__Actinomycetaceae; g__Actinomyces; s__	1.00	3
New.CleanUp.ReferenceOTU91	k__Bacteria; p__Firmicutes; c__Clostridia; o__Clostridiales; f__[Tissierellaceae]; g__Peptoniphilus; s__	1.00	3
New.CleanUp.ReferenceOTU776	k__Bacteria; p__Firmicutes; c__Clostridia; o__Clostridiales; f__Lachnospiraceae; g__; s__	0.67	3
New.CleanUp.ReferenceOTU933	k__Bacteria; p__Bacteroidetes; c__Flavobacteriia; o__Flavobacteriales; f__[Weeksellaceae]; g__; s__	1.00	3
New.CleanUp.ReferenceOTU651	k__Bacteria; p__Proteobacteria; c__Betaproteobacteria; o__Burkholderiales; f__Comamonadaceae; g__Delftia; s__	1.00	3
New.CleanUp.ReferenceOTU1341	k__Bacteria; p__Firmicutes; c__Clostridia; o__Clostridiales; f__[Tissierellaceae]; g__Anaerococcus; s__	1.00	3
New.CleanUp.ReferenceOTU1029	k__Bacteria; p__Firmicutes; c__Bacilli; o__Lactobacillales; f__Streptococcaceae; g__Streptococcus; s__	1.00	3
New.CleanUp.ReferenceOTU1435	k__Bacteria; p__Firmicutes; c__Bacilli; o__Lactobacillales; f__Streptococcaceae; g__Streptococcus; s__	1.00	3
New.CleanUp.ReferenceOTU1434	k__Bacteria; p__Cyanobacteria; c__Chloroplast; o__Streptophyta; f__; g__; s__	1.00	3
New.CleanUp.ReferenceOTU1433	k__Bacteria; p__Proteobacteria; c__Alphaproteobacteria; o__Sphingomonadales; f__Sphingomonadaceae; g__Sphingomonas; s__suberifaciens	0.67	3
New.CleanUp.ReferenceOTU1344	k__Bacteria; p__Firmicutes; c__Clostridia; o__Clostridiales; f__Ruminococcaceae; g__; s__	0.67	3
New.CleanUp.ReferenceOTU1431	k__Bacteria; p__Proteobacteria; c__Betaproteobacteria; o__Burkholderiales; f__Oxalobacteraceae; g__Cupriavidus; s__	0.67	3
New.CleanUp.ReferenceOTU195	k__Bacteria; p__Actinobacteria; c__Actinobacteria; o__Actinomycetales; f__Propionibacteriaceae; g__Propionibacterium; s__acnes	1.00	3
New.CleanUp.ReferenceOTU1349	k__Bacteria; p__Firmicutes; c__Clostridia; o__Clostridiales; f__[Tissierellaceae]; g__Peptoniphilus; s__	1.00	3
New.CleanUp.ReferenceOTU1021	k__Bacteria; p__Proteobacteria; c__Gammaproteobacteria; o__Pseudomonadales; f__Moraxellaceae; g__Acinetobacter; s__	0.67	3
New.CleanUp.ReferenceOTU198	k__Bacteria; p__Firmicutes; c__Clostridia; o__Clostridiales; f__Veillonellaceae; g__Veillonella; s__dispar	1.00	3
New.CleanUp.ReferenceOTU582	k__Bacteria; p__Proteobacteria; c__Alphaproteobacteria; o__Sphingomonadales; f__Sphingomonadaceae; g__Sphingobium; s__	1.00	3
New.CleanUp.ReferenceOTU584	k__Bacteria; p__Actinobacteria; c__Actinobacteria; o__Actinomycetales; f__Propionibacteriaceae; g__Propionibacterium; s__acnes	0.67	3
New.CleanUp.ReferenceOTU1026	k__Bacteria; p__Actinobacteria; c__Actinobacteria; o__Actinomycetales; f__Propionibacteriaceae; g__Propionibacterium; s__acnes	0.67	3
New.CleanUp.ReferenceOTU1438	k__Bacteria; p__Firmicutes; c__Bacilli; o__Lactobacillales; f__Streptococcaceae; g__Streptococcus; s__	1.00	3
New.CleanUp.ReferenceOTU1509	Unassigned	1.00	1
New.CleanUp.ReferenceOTU106	k__Bacteria; p__Firmicutes; c__Bacilli; o__Lactobacillales; f__Streptococcaceae; g__Streptococcus; s__	1.00	3
New.CleanUp.ReferenceOTU538	k__Bacteria; p__Proteobacteria; c__Alphaproteobacteria; o__Rickettsiales; f__mitochondria	1.00	3
New.CleanUp.ReferenceOTU539	k__Bacteria; p__Firmicutes; c__Clostridia; o__Clostridiales; f__Lachnospiraceae; g__Lachnospira; s__	0.67	3
New.CleanUp.ReferenceOTU103	k__Bacteria; p__Firmicutes; c__Clostridia; o__Clostridiales; f__Lachnospiraceae; g__; s__	0.67	3
New.CleanUp.ReferenceOTU102	k__Bacteria; p__Firmicutes; c__Clostridia; o__Clostridiales; f__Peptococcaceae; g__Peptococcus; s__	1.00	1
New.CleanUp.ReferenceOTU1503	k__Bacteria; p__Actinobacteria; c__Actinobacteria; o__Actinomycetales; f__Propionibacteriaceae; g__Propionibacterium; s__acnes	1.00	3
New.CleanUp.ReferenceOTU1502	k__Bacteria; p__Actinobacteria; c__Actinobacteria; o__Actinomycetales; f__Propionibacteriaceae; g__Propionibacterium; s__acnes	1.00	1
New.CleanUp.ReferenceOTU1501	k__Bacteria; p__Actinobacteria; c__Actinobacteria; o__Actinomycetales; f__Corynebacteriaceae; g__Corynebacterium; s__	1.00	3
New.CleanUp.ReferenceOTU1507	k__Bacteria; p__Actinobacteria; c__Actinobacteria; o__Actinomycetales; f__Sanguibacteraceae; g__Sanguibacter; s__	0.67	3
New.CleanUp.ReferenceOTU532	k__Bacteria; p__Actinobacteria; c__Actinobacteria; o__Actinomycetales; f__Corynebacteriaceae; g__Corynebacterium; s__	1.00	1
New.CleanUp.ReferenceOTU1504	k__Bacteria; p__Firmicutes; c__Clostridia; o__Clostridiales; f__[Tissierellaceae]; g__WAL_1855D; s__	1.00	3
New.CleanUp.ReferenceOTU227	k__Bacteria; p__Bacteroidetes; c__Bacteroidia; o__Bacteroidales; f__Porphyromonadaceae; g__Tannerella; s__	1.00	3
New.CleanUp.ReferenceOTU804	k__Bacteria; p__Actinobacteria; c__Actinobacteria; o__Actinomycetales; f__Corynebacteriaceae; g__Corynebacterium; s__	0.67	3
New.CleanUp.ReferenceOTU189	k__Bacteria; p__Firmicutes; c__Clostridia; o__Clostridiales; f__; g__; s__	0.67	3
New.CleanUp.ReferenceOTU1421	k__Bacteria; p__Firmicutes; c__Clostridia; o__Clostridiales; f__[Tissierellaceae]; g__Peptoniphilus; s__	1.00	3
New.CleanUp.ReferenceOTU1334	k__Bacteria; p__Bacteroidetes; c__Bacteroidia; o__Bacteroidales; f__[Paraprevotellaceae]; g__Paraprevotella; s__	0.67	3
New.CleanUp.ReferenceOTU1489	k__Bacteria; p__Actinobacteria; c__Actinobacteria; o__Bifidobacteriales; f__Bifidobacteriaceae; g__Bifidobacterium; s__adolescentis	0.67	3
New.CleanUp.ReferenceOTU1330	k__Bacteria; p__Proteobacteria; c__Alphaproteobacteria; o__Rhizobiales; f__Bartonellaceae; g__Bartonella; s__	0.67	3
New.CleanUp.ReferenceOTU966	k__Bacteria; p__Actinobacteria; c__Actinobacteria; o__Actinomycetales; f__Actinomycetaceae; g__Actinomyces; s__	1.00	3
New.CleanUp.ReferenceOTU695	k__Bacteria; p__Proteobacteria; c__Gammaproteobacteria; o__Pasteurellales; f__Pasteurellaceae; g__Actinobacillus; s__	0.67	3
New.CleanUp.ReferenceOTU1483	k__Bacteria; p__Firmicutes; c__Clostridia; o__Clostridiales; f__[Tissierellaceae]; g__Anaerococcus; s__	1.00	3
New.CleanUp.ReferenceOTU1480	k__Bacteria; p__Bacteroidetes; c__[Saprospirae]; o__[Saprospirales]; f__Chitinophagaceae; g__; s__	1.00	3
New.CleanUp.ReferenceOTU634	k__Bacteria; p__Actinobacteria; c__Coriobacteriia; o__Coriobacteriales; f__Coriobacteriaceae; g__Collinsella; s__aerofaciens	1.00	3
New.CleanUp.ReferenceOTU965	k__Bacteria; p__Proteobacteria; c__Alphaproteobacteria; o__Rhizobiales; f__; g__; s__	0.67	3
New.CleanUp.ReferenceOTU1485	k__Bacteria; p__Proteobacteria; c__Alphaproteobacteria; o__Rhizobiales; f__Rhizobiaceae; g__Agrobacterium; s__	1.00	3
New.CleanUp.ReferenceOTU444	k__Bacteria; p__Proteobacteria; c__Gammaproteobacteria; o__Pasteurellales; f__Pasteurellaceae; g__Haemophilus; s__parainfluenzae	1.00	3
New.CleanUp.ReferenceOTU446	k__Bacteria; p__Firmicutes; c__Bacilli; o__Bacillales; f__Staphylococcaceae; g__Staphylococcus; s__aureus	1.00	3
New.CleanUp.ReferenceOTU447	k__Bacteria; p__Actinobacteria; c__Actinobacteria; o__Actinomycetales; f__Actinomycetaceae; g__Actinomyces; s__	1.00	3
New.CleanUp.ReferenceOTU1239	k__Bacteria; p__Proteobacteria; c__Betaproteobacteria; o__Neisseriales; f__Neisseriaceae; g__Neisseria; s__	0.67	3
New.CleanUp.ReferenceOTU441	k__Bacteria; p__Firmicutes; c__Clostridia; o__Clostridiales; f__Ruminococcaceae; g__; s__	0.67	3
New.CleanUp.ReferenceOTU762	k__Bacteria; p__Proteobacteria; c__Betaproteobacteria; o__Burkholderiales; f__; g__; s__	1.00	3
New.CleanUp.ReferenceOTU364	k__Bacteria; p__Firmicutes; c__Clostridia; o__Clostridiales	1.00	3
New.CleanUp.ReferenceOTU1236	k__Bacteria; p__Actinobacteria; c__Actinobacteria; o__Actinomycetales; f__Corynebacteriaceae; g__Corynebacterium; s__	1.00	3
New.CleanUp.ReferenceOTU448	k__Bacteria; p__Actinobacteria; c__Actinobacteria; o__Actinomycetales; f__Propionibacteriaceae; g__Propionibacterium; s__acnes	0.67	3
New.CleanUp.ReferenceOTU187	k__Bacteria; p__Bacteroidetes; c__Flavobacteriia; o__Flavobacteriales; f__Flavobacteriaceae; g__Capnocytophaga; s__	1.00	3
New.CleanUp.ReferenceOTU363	k__Bacteria; p__Firmicutes; c__Clostridia; o__Clostridiales	1.00	3
New.CleanUp.ReferenceOTU1232	k__Bacteria; p__Firmicutes; c__Clostridia; o__Clostridiales; f__[Tissierellaceae]; g__Anaerococcus; s__	1.00	3
New.CleanUp.ReferenceOTU746	k__Bacteria; p__Firmicutes; c__Clostridia; o__Clostridiales; f__[Tissierellaceae]; g__Peptoniphilus; s__	1.00	1
New.CleanUp.ReferenceOTU213	k__Bacteria; p__Firmicutes; c__Clostridia; o__Clostridiales; f__Ruminococcaceae; g__Ruminococcus	0.67	3
New.CleanUp.ReferenceOTU212	k__Bacteria; p__Firmicutes; c__Bacilli; o__Lactobacillales; f__Aerococcaceae; g__Alloiococcus; s__otitis	1.00	3
New.CleanUp.ReferenceOTU743	k__Bacteria; p__Bacteroidetes; c__Bacteroidia; o__Bacteroidales; f__Prevotellaceae; g__Prevotella; s__	1.00	2
New.CleanUp.ReferenceOTU214	k__Bacteria; p__Proteobacteria; c__Alphaproteobacteria; o__Caulobacterales; f__Caulobacteraceae; g__Caulobacter; s__	0.67	3
New.CleanUp.ReferenceOTU180	k__Bacteria; p__Proteobacteria; c__Alphaproteobacteria; o__Sphingomonadales; f__Sphingomonadaceae; g__Kaistobacter; s__	1.00	3
New.CleanUp.ReferenceOTU806	k__Bacteria; p__Firmicutes; c__Clostridia; o__Clostridiales; f__Lachnospiraceae	0.67	3
New.CleanUp.ReferenceOTU1150	k__Bacteria; p__Proteobacteria; c__Alphaproteobacteria; o__Rhizobiales; f__Bradyrhizobiaceae; g__Balneimonas; s__	1.00	3
New.CleanUp.ReferenceOTU1151	k__Bacteria; p__Bacteroidetes; c__Flavobacteriia; o__Flavobacteriales; f__Flavobacteriaceae; g__Flavobacterium; s__	0.67	3
New.CleanUp.ReferenceOTU1152	k__Bacteria; p__Bacteroidetes; c__Bacteroidia; o__Bacteroidales; f__Prevotellaceae; g__Prevotella; s__nigrescens	1.00	3
New.CleanUp.ReferenceOTU840	k__Bacteria; p__Firmicutes; c__Clostridia; o__Clostridiales; f__[Tissierellaceae]; g__Peptoniphilus; s__	1.00	3
New.CleanUp.ReferenceOTU843	k__Bacteria; p__Firmicutes; c__Bacilli; o__Lactobacillales; f__Streptococcaceae; g__Streptococcus; s__	1.00	3
New.CleanUp.ReferenceOTU844	k__Bacteria; p__Proteobacteria; c__Betaproteobacteria; o__Neisseriales; f__Neisseriaceae; g__Neisseria	0.67	3
New.CleanUp.ReferenceOTU968	k__Bacteria; p__Bacteroidetes; c__Bacteroidia; o__Bacteroidales; f__Porphyromonadaceae; g__Parabacteroides; s__distasonis	0.67	3
New.CleanUp.ReferenceOTU654	k__Bacteria; p__Actinobacteria; c__Actinobacteria; o__Actinomycetales; f__Micrococcaceae; g__Rothia	0.67	3
New.CleanUp.ReferenceOTU643	k__Bacteria; p__Proteobacteria; c__Alphaproteobacteria; o__Rhizobiales; f__Methylobacteriaceae; g__Methylobacterium; s__	1.00	3
New.CleanUp.ReferenceOTU563	k__Bacteria; p__Firmicutes; c__Bacilli; o__Lactobacillales; f__Streptococcaceae; g__Streptococcus; s__	0.67	3
New.CleanUp.ReferenceOTU998	k__Bacteria; p__Actinobacteria; c__Actinobacteria; o__Actinomycetales; f__Propionibacteriaceae; g__; s__	1.00	3
New.CleanUp.ReferenceOTU999	k__Bacteria; p__Actinobacteria; c__Actinobacteria; o__Actinomycetales; f__Propionibacteriaceae; g__Propionibacterium; s__granulosum	0.67	3
New.CleanUp.ReferenceOTU991	k__Bacteria; p__Firmicutes; c__Clostridia; o__Clostridiales; f__Ruminococcaceae; g__; s__	0.67	3
New.CleanUp.ReferenceOTU996	k__Bacteria; p__Firmicutes; c__Clostridia; o__Clostridiales; f__Lachnospiraceae; g__Oribacterium; s__	1.00	3
New.CleanUp.ReferenceOTU995	k__Bacteria; p__Firmicutes; c__Clostridia; o__Clostridiales; f__Veillonellaceae; g__Veillonella; s__dispar	1.00	3
New.CleanUp.ReferenceOTU526	k__Bacteria; p__Bacteroidetes; c__Sphingobacteriia; o__Sphingobacteriales; f__Sphingobacteriaceae; g__Sphingobacterium; s__faecium	1.00	3
New.CleanUp.ReferenceOTU525	k__Bacteria; p__Bacteroidetes; c__Flavobacteriia; o__Flavobacteriales; f__Flavobacteriaceae; g__Flavobacterium; s__	0.67	3
New.CleanUp.ReferenceOTU816	k__Bacteria; p__Actinobacteria; c__Actinobacteria; o__Actinomycetales; f__Kineosporiaceae; g__; s__	0.67	3
New.CleanUp.ReferenceOTU523	k__Bacteria; p__Cyanobacteria; c__Chloroplast; o__Streptophyta; f__; g__; s__	1.00	3
New.CleanUp.ReferenceOTU564	k__Bacteria; p__Firmicutes; c__Clostridia; o__Clostridiales; f__[Tissierellaceae]; g__1-68; s__	0.67	3
New.CleanUp.ReferenceOTU833	k__Bacteria; p__Cyanobacteria; c__Chloroplast; o__Streptophyta; f__; g__; s__	1.00	3
New.CleanUp.ReferenceOTU521	k__Bacteria; p__Firmicutes; c__Clostridia; o__Clostridiales; f__Ruminococcaceae; g__; s__	0.67	3
New.CleanUp.ReferenceOTU545	k__Bacteria; p__Firmicutes; c__Bacilli; o__Turicibacterales; f__Turicibacteraceae; g__Turicibacter; s__	0.67	3
New.CleanUp.ReferenceOTU547	k__Bacteria; p__Firmicutes; c__Clostridia; o__Clostridiales; f__; g__; s__	0.67	3
New.CleanUp.ReferenceOTU546	k__Bacteria; p__Firmicutes; c__Clostridia; o__Clostridiales; f__Lachnospiraceae; g__; s__	1.00	3
New.CleanUp.ReferenceOTU540	k__Bacteria; p__Firmicutes; c__Clostridia; o__Clostridiales; f__Lachnospiraceae; g__Coprococcus; s__	1.00	3
New.CleanUp.ReferenceOTU543	k__Bacteria; p__Actinobacteria; c__Actinobacteria; o__Actinomycetales; f__Microbacteriaceae; g__Curtobacterium; s__	1.00	3
New.CleanUp.ReferenceOTU542	k__Bacteria; p__Firmicutes; c__Erysipelotrichi; o__Erysipelotrichales; f__Erysipelotrichaceae; g__; s__	1.00	3
New.CleanUp.ReferenceOTU549	k__Bacteria; p__Firmicutes; c__Bacilli; o__Bacillales; f__Staphylococcaceae; g__Staphylococcus; s__	1.00	3
New.CleanUp.ReferenceOTU140	k__Bacteria; p__Bacteroidetes; c__Cytophagia; o__Cytophagales; f__Cytophagaceae; g__Hymenobacter; s__	1.00	3
New.CleanUp.ReferenceOTU143	k__Bacteria; p__Bacteroidetes; c__Flavobacteriia; o__Flavobacteriales; f__[Weeksellaceae]; g__Cloacibacterium; s__	1.00	3
New.CleanUp.ReferenceOTU142	k__Bacteria; p__Firmicutes; c__Clostridia; o__Clostridiales; f__[Tissierellaceae]; g__Anaerococcus; s__	1.00	3
New.CleanUp.ReferenceOTU145	k__Bacteria; p__Firmicutes; c__Bacilli; o__Lactobacillales; f__Carnobacteriaceae; g__Granulicatella; s__	1.00	3
New.CleanUp.ReferenceOTU144	k__Bacteria; p__Actinobacteria; c__Actinobacteria; o__Actinomycetales; f__Corynebacteriaceae; g__Corynebacterium; s__	1.00	3
New.CleanUp.ReferenceOTU147	k__Bacteria; p__Firmicutes; c__Clostridia; o__Clostridiales; f__Clostridiaceae; g__Clostridium; s__	1.00	3
New.CleanUp.ReferenceOTU146	k__Bacteria; p__Bacteroidetes; c__Bacteroidia; o__Bacteroidales; f__Prevotellaceae; g__Prevotella; s__melaninogenica	0.67	3
New.CleanUp.ReferenceOTU149	k__Bacteria; p__Actinobacteria; c__Actinobacteria; o__Actinomycetales; f__Corynebacteriaceae; g__Corynebacterium; s__	0.67	3
New.CleanUp.ReferenceOTU148	k__Bacteria; p__Actinobacteria; c__Actinobacteria; o__Actinomycetales; f__Corynebacteriaceae; g__Corynebacterium; s__	1.00	3
New.CleanUp.ReferenceOTU1077	k__Bacteria; p__Proteobacteria; c__Alphaproteobacteria; o__Sphingomonadales; f__Sphingomonadaceae; g__Sphingobium; s__	1.00	3
New.CleanUp.ReferenceOTU1071	k__Bacteria; p__Firmicutes; c__Clostridia; o__Clostridiales; f__Ruminococcaceae; g__; s__	0.67	3
New.CleanUp.ReferenceOTU1070	k__Bacteria; p__Proteobacteria; c__Gammaproteobacteria; o__Pseudomonadales; f__Moraxellaceae; g__Psychrobacter	0.67	3
New.CleanUp.ReferenceOTU1079	k__Bacteria; p__Bacteroidetes; c__Flavobacteriia; o__Flavobacteriales; f__Flavobacteriaceae; g__Flavobacterium; s__	1.00	3
New.CleanUp.ReferenceOTU1078	k__Bacteria; p__Actinobacteria; c__Actinobacteria; o__Actinomycetales; f__Micrococcaceae; g__Micrococcus	0.67	3
New.CleanUp.ReferenceOTU242	k__Bacteria; p__Firmicutes; c__Clostridia; o__Clostridiales; f__Lachnospiraceae	0.67	3
New.CleanUp.ReferenceOTU243	k__Bacteria; p__Firmicutes; c__Clostridia; o__Clostridiales; f__Ruminococcaceae; g__Oscillospira; s__	0.67	3
New.CleanUp.ReferenceOTU240	k__Bacteria; p__Actinobacteria; c__Actinobacteria; o__Actinomycetales; f__Actinomycetaceae; g__Varibaculum; s__	1.00	3
New.CleanUp.ReferenceOTU713	k__Bacteria; p__Bacteroidetes; c__Bacteroidia; o__Bacteroidales; f__Prevotellaceae; g__Prevotella; s__	1.00	3
New.CleanUp.ReferenceOTU714	k__Bacteria; p__Firmicutes; c__Clostridia; o__Clostridiales; f__Lachnospiraceae; g__Coprococcus; s__	1.00	3
New.CleanUp.ReferenceOTU247	k__Bacteria; p__Firmicutes; c__Clostridia; o__Clostridiales; f__Ruminococcaceae	0.67	3
New.CleanUp.ReferenceOTU244	k__Bacteria; p__Firmicutes; c__Bacilli; o__Bacillales; f__Staphylococcaceae; g__Staphylococcus	0.67	3
New.CleanUp.ReferenceOTU245	k__Bacteria; p__Bacteroidetes; c__Bacteroidia; o__Bacteroidales; f__Prevotellaceae; g__Prevotella; s__copri	1.00	3
New.CleanUp.ReferenceOTU1370	k__Bacteria; p__Proteobacteria; c__Gammaproteobacteria; o__Pseudomonadales; f__Moraxellaceae; g__Acinetobacter; s__	1.00	3
New.CleanUp.ReferenceOTU1371	k__Bacteria; p__Bacteroidetes; c__Bacteroidia; o__Bacteroidales; f__Prevotellaceae; g__Prevotella; s__	1.00	3
New.CleanUp.ReferenceOTU1372	k__Bacteria; p__Proteobacteria; c__Betaproteobacteria; o__Burkholderiales; f__Oxalobacteraceae; g__Janthinobacterium; s__lividum	0.67	3
New.CleanUp.ReferenceOTU1374	k__Bacteria; p__Actinobacteria; c__Actinobacteria; o__Actinomycetales; f__Microbacteriaceae; g__Rathayibacter; s__caricis	0.67	3
New.CleanUp.ReferenceOTU954	k__Bacteria; p__Actinobacteria; c__Actinobacteria; o__Actinomycetales; f__Corynebacteriaceae; g__Corynebacterium; s__	1.00	3
New.CleanUp.ReferenceOTU1479	k__Bacteria; p__Actinobacteria; c__Actinobacteria; o__Actinomycetales; f__Nocardioidaceae; g__Friedmanniella; s__	1.00	3
New.CleanUp.ReferenceOTU1478	k__Bacteria; p__Firmicutes; c__Clostridia; o__Clostridiales; f__Ruminococcaceae; g__Faecalibacterium; s__prausnitzii	0.67	3
New.CleanUp.ReferenceOTU668	k__Bacteria; p__Bacteroidetes; c__Flavobacteriia; o__Flavobacteriales; f__Flavobacteriaceae; g__Flavobacterium; s__	0.67	3
New.CleanUp.ReferenceOTU669	k__Bacteria; p__Actinobacteria; c__Actinobacteria; o__Actinomycetales; f__Microbacteriaceae; g__Frigoribacterium; s__	0.67	3
New.CleanUp.ReferenceOTU1473	k__Bacteria; p__Bacteroidetes; c__Flavobacteriia; o__Flavobacteriales; f__Flavobacteriaceae; g__Capnocytophaga; s__	1.00	3
New.CleanUp.ReferenceOTU404	k__Bacteria; p__Bacteroidetes; c__Bacteroidia; o__Bacteroidales; f__Prevotellaceae; g__Prevotella; s__	1.00	3
New.CleanUp.ReferenceOTU1470	k__Bacteria; p__Fusobacteria; c__Fusobacteriia; o__Fusobacteriales; f__Leptotrichiaceae; g__Leptotrichia; s__	1.00	3
New.CleanUp.ReferenceOTU660	k__Bacteria; p__Bacteroidetes; c__Bacteroidia; o__Bacteroidales; f__Prevotellaceae; g__Prevotella; s__	1.00	1
New.CleanUp.ReferenceOTU663	k__Bacteria; p__Proteobacteria; c__Betaproteobacteria; o__Burkholderiales; f__Comamonadaceae; g__; s__	1.00	3
New.CleanUp.ReferenceOTU396	k__Bacteria; p__Firmicutes; c__Clostridia; o__Clostridiales; f__; g__; s__	0.67	3
New.CleanUp.ReferenceOTU1204	k__Bacteria; p__Actinobacteria; c__Actinobacteria; o__Actinomycetales; f__Corynebacteriaceae; g__Corynebacterium; s__	0.67	3
New.CleanUp.ReferenceOTU1205	k__Bacteria; p__Firmicutes; c__Clostridia; o__Clostridiales; f__[Tissierellaceae]; g__Peptoniphilus; s__	1.00	3
New.CleanUp.ReferenceOTU1206	k__Bacteria; p__Actinobacteria; c__Actinobacteria; o__Actinomycetales; f__Brevibacteriaceae; g__Brevibacterium; s__	0.67	3
New.CleanUp.ReferenceOTU764	k__Bacteria; p__Proteobacteria; c__Alphaproteobacteria; o__Sphingomonadales; f__Sphingomonadaceae	1.00	3
New.CleanUp.ReferenceOTU1201	k__Bacteria; p__Chloroflexi; c__Thermomicrobia; o__JG30-KF-CM45; f__; g__; s__	1.00	2
New.CleanUp.ReferenceOTU802	k__Bacteria; p__Firmicutes; c__Clostridia; o__Clostridiales; f__Lachnospiraceae; g__Moryella; s__	0.67	3
New.CleanUp.ReferenceOTU1203	k__Bacteria; p__Actinobacteria; c__Actinobacteria; o__Actinomycetales; f__Microbacteriaceae; g__Clavibacter; s__michiganensis	0.67	3
New.CleanUp.ReferenceOTU808	k__Bacteria; p__Fusobacteria; c__Fusobacteriia; o__Fusobacteriales; f__Fusobacteriaceae; g__Fusobacterium; s__	1.00	3
New.CleanUp.ReferenceOTU1195	k__Bacteria; p__Firmicutes; c__Clostridia; o__Clostridiales; f__[Tissierellaceae]; g__Anaerococcus; s__	1.00	3
New.CleanUp.ReferenceOTU1197	k__Bacteria; p__Firmicutes; c__Bacilli; o__Lactobacillales; f__Aerococcaceae; g__Alloiococcus; s__otitis	1.00	3
New.CleanUp.ReferenceOTU439	k__Bacteria; p__Proteobacteria; c__Betaproteobacteria; o__Burkholderiales; f__Comamonadaceae; g__; s__	0.67	3
New.CleanUp.ReferenceOTU438	k__Bacteria; p__Firmicutes; c__Bacilli; o__Lactobacillales; f__Lactobacillaceae; g__Lactobacillus; s__zeae	0.67	3
New.CleanUp.ReferenceOTU1192	k__Bacteria; p__Proteobacteria; c__Gammaproteobacteria; o__Pseudomonadales; f__Pseudomonadaceae; g__Pseudomonas; s__stutzeri	0.67	3
New.CleanUp.ReferenceOTU437	k__Bacteria; p__Firmicutes; c__Bacilli; o__Bacillales; f__Staphylococcaceae; g__Staphylococcus; s__	0.67	3
New.CleanUp.ReferenceOTU431	k__Bacteria; p__Firmicutes; c__Bacilli; o__Lactobacillales; f__Streptococcaceae; g__Streptococcus; s__	1.00	3
New.CleanUp.ReferenceOTU430	k__Bacteria; p__Bacteroidetes; c__Bacteroidia; o__Bacteroidales; f__Prevotellaceae; g__Prevotella; s__	1.00	3
New.CleanUp.ReferenceOTU433	k__Bacteria; p__Bacteroidetes; c__Bacteroidia; o__Bacteroidales; f__Prevotellaceae; g__Prevotella; s__	1.00	3
New.CleanUp.ReferenceOTU432	k__Bacteria; p__Bacteroidetes; c__[Saprospirae]; o__[Saprospirales]; f__Chitinophagaceae; g__Segetibacter; s__	1.00	3
New.CleanUp.ReferenceOTU329	k__Bacteria; p__Firmicutes; c__Clostridia; o__Clostridiales; f__Ruminococcaceae; g__; s__	1.00	3
New.CleanUp.ReferenceOTU481	k__Bacteria; p__Firmicutes; c__Bacilli; o__Bacillales; f__Staphylococcaceae; g__Staphylococcus; s__	1.00	3
New.CleanUp.ReferenceOTU482	k__Bacteria; p__Actinobacteria; c__Actinobacteria; o__Actinomycetales; f__Micrococcaceae; g__; s__	0.67	3
New.CleanUp.ReferenceOTU483	k__Bacteria; p__Actinobacteria; c__Actinobacteria; o__Actinomycetales; f__Microbacteriaceae; g__Pseudoclavibacter; s__bifida	0.67	3
New.CleanUp.ReferenceOTU484	k__Bacteria; p__Bacteroidetes; c__Bacteroidia; o__Bacteroidales; f__Prevotellaceae; g__Prevotella; s__nanceiensis	1.00	3
New.CleanUp.ReferenceOTU485	k__Bacteria; p__Proteobacteria; c__Alphaproteobacteria; o__Rhodospirillales; f__Acetobacteraceae; g__; s__	0.67	3
New.CleanUp.ReferenceOTU487	k__Bacteria; p__Firmicutes; c__Bacilli; o__Lactobacillales; f__Leuconostocaceae; g__Leuconostoc; s__	1.00	3
New.CleanUp.ReferenceOTU321	k__Bacteria; p__Actinobacteria; c__Actinobacteria; o__Actinomycetales; f__Geodermatophilaceae; g__; s__	1.00	3
New.CleanUp.ReferenceOTU896	k__Bacteria; p__Firmicutes; c__Clostridia; o__Clostridiales; f__[Tissierellaceae]; g__Peptoniphilus; s__	1.00	3
New.CleanUp.ReferenceOTU323	k__Bacteria; p__Firmicutes; c__Clostridia; o__Clostridiales; f__[Tissierellaceae]; g__Anaerococcus; s__	1.00	3
New.CleanUp.ReferenceOTU322	k__Bacteria; p__Firmicutes; c__Clostridia; o__Clostridiales; f__Ruminococcaceae; g__; s__	1.00	3
New.CleanUp.ReferenceOTU325	k__Bacteria; p__Fusobacteria; c__Fusobacteriia; o__Fusobacteriales; f__Fusobacteriaceae; g__Fusobacterium; s__	1.00	3
New.CleanUp.ReferenceOTU892	k__Bacteria; p__Firmicutes; c__Bacilli; o__Lactobacillales; f__Streptococcaceae; g__Lactococcus; s__	1.00	3
New.CleanUp.ReferenceOTU327	k__Bacteria; p__Proteobacteria; c__Betaproteobacteria; o__Neisseriales; f__Neisseriaceae; g__Kingella; s__	1.00	3
New.CleanUp.ReferenceOTU986	k__Bacteria; p__Actinobacteria; c__Actinobacteria; o__Actinomycetales; f__Corynebacteriaceae; g__Corynebacterium; s__	0.67	3
New.CleanUp.ReferenceOTU81	k__Bacteria; p__Firmicutes; c__Bacilli; o__Lactobacillales; f__Streptococcaceae; g__Streptococcus; s__	1.00	3
New.CleanUp.ReferenceOTU1312	k__Bacteria; p__Fusobacteria; c__Fusobacteriia; o__Fusobacteriales; f__Fusobacteriaceae; g__Fusobacterium; s__	1.00	3
New.CleanUp.ReferenceOTU983	k__Bacteria; p__Cyanobacteria; c__Chloroplast; o__Streptophyta; f__; g__; s__	1.00	3
New.CleanUp.ReferenceOTU1108	k__Bacteria; p__Proteobacteria; c__Betaproteobacteria; o__Burkholderiales; f__Comamonadaceae; g__; s__	0.67	3
New.CleanUp.ReferenceOTU1106	k__Bacteria; p__Firmicutes; c__Clostridia; o__Clostridiales; f__Lachnospiraceae	0.67	3
New.CleanUp.ReferenceOTU1104	k__Bacteria; p__Firmicutes; c__Bacilli; o__Bacillales; f__Alicyclobacillaceae; g__Alicyclobacillus; s__	1.00	2
New.CleanUp.ReferenceOTU1100	k__Bacteria; p__Proteobacteria; c__Alphaproteobacteria; o__Caulobacterales; f__Caulobacteraceae; g__; s__	1.00	3
New.CleanUp.ReferenceOTU826	k__Bacteria; p__Actinobacteria; c__Actinobacteria; o__Actinomycetales; f__Yaniellaceae; g__Yaniella; s__	1.00	3
New.CleanUp.ReferenceOTU618	k__Bacteria; p__Actinobacteria; c__Actinobacteria; o__Actinomycetales; f__Actinomycetaceae; g__Actinomyces; s__	1.00	1
New.CleanUp.ReferenceOTU822	k__Bacteria; p__Firmicutes; c__Clostridia; o__Clostridiales; f__[Tissierellaceae]; g__Anaerococcus; s__	1.00	3
New.CleanUp.ReferenceOTU823	k__Bacteria; p__Cyanobacteria; c__Chloroplast; o__Streptophyta; f__; g__; s__	1.00	3
New.CleanUp.ReferenceOTU57	k__Bacteria; p__TM7; c__TM7-3; o__; f__; g__; s__	1.00	3
New.CleanUp.ReferenceOTU1296	k__Bacteria; p__Firmicutes; c__Bacilli; o__Lactobacillales; f__Streptococcaceae; g__Streptococcus; s__	1.00	3
New.CleanUp.ReferenceOTU29	k__Bacteria; p__Firmicutes; c__Clostridia; o__Clostridiales; f__Lachnospiraceae; g__; s__	0.67	3
New.CleanUp.ReferenceOTU24	k__Bacteria; p__Bacteroidetes; c__Bacteroidia; o__Bacteroidales; f__Prevotellaceae; g__Prevotella; s__intermedia	0.67	3
New.CleanUp.ReferenceOTU21	k__Bacteria; p__Firmicutes; c__Clostridia; o__Clostridiales; f__Veillonellaceae; g__Veillonella; s__dispar	0.67	3
New.CleanUp.ReferenceOTU20	k__Bacteria; p__Bacteroidetes; c__Bacteroidia; o__Bacteroidales; f__Prevotellaceae; g__Prevotella; s__	1.00	3
New.CleanUp.ReferenceOTU22	k__Bacteria; p__Firmicutes; c__Bacilli; o__Lactobacillales; f__Streptococcaceae; g__Streptococcus; s__	1.00	3
New.CleanUp.ReferenceOTU754	k__Bacteria; p__Actinobacteria; c__Acidimicrobiia; o__Acidimicrobiales; f__C111; g__; s__	1.00	3
New.CleanUp.ReferenceOTU304	k__Bacteria; p__Firmicutes; c__Bacilli; o__Lactobacillales; f__Streptococcaceae; g__Streptococcus; s__	1.00	3
New.CleanUp.ReferenceOTU1402	k__Bacteria; p__Firmicutes; c__Clostridia; o__Clostridiales; f__Ruminococcaceae; g__Faecalibacterium; s__prausnitzii	0.67	3
New.CleanUp.ReferenceOTU1403	k__Bacteria; p__Proteobacteria; c__Betaproteobacteria; o__Burkholderiales; f__Oxalobacteraceae; g__; s__	0.67	3
New.CleanUp.ReferenceOTU1039	k__Bacteria; p__Actinobacteria; c__Actinobacteria; o__Actinomycetales; f__Corynebacteriaceae; g__Corynebacterium; s__	1.00	3
New.CleanUp.ReferenceOTU616	k__Bacteria; p__Proteobacteria; c__Betaproteobacteria; o__Neisseriales; f__Neisseriaceae; g__; s__	1.00	3
New.CleanUp.ReferenceOTU1406	k__Bacteria; p__Cyanobacteria; c__Chloroplast; o__Streptophyta; f__; g__; s__	1.00	3
New.CleanUp.ReferenceOTU1404	k__Bacteria; p__Proteobacteria; c__Gammaproteobacteria; o__Pseudomonadales; f__Moraxellaceae; g__Moraxella; s__	1.00	3
New.CleanUp.ReferenceOTU1405	k__Bacteria; p__Firmicutes; c__Clostridia; o__Clostridiales; f__Lachnospiraceae	0.67	3
New.CleanUp.ReferenceOTU596	k__Bacteria; p__Proteobacteria; c__Gammaproteobacteria; o__Pseudomonadales; f__Pseudomonadaceae; g__Pseudomonas; s__	1.00	3
New.CleanUp.ReferenceOTU597	k__Bacteria; p__Firmicutes; c__Bacilli; o__Lactobacillales; f__Streptococcaceae; g__Streptococcus; s__	0.67	3
New.CleanUp.ReferenceOTU1031	k__Bacteria; p__Bacteroidetes; c__Bacteroidia; o__Bacteroidales; f__Prevotellaceae; g__Prevotella; s__	1.00	3
New.CleanUp.ReferenceOTU1409	k__Bacteria; p__Proteobacteria; c__Gammaproteobacteria; o__Oceanospirillales; f__Oceanospirillaceae; g__Marinomonas; s__	1.00	3
New.CleanUp.ReferenceOTU1037	k__Bacteria; p__Actinobacteria; c__Actinobacteria; o__Actinomycetales; f__Corynebacteriaceae; g__Corynebacterium; s__	0.67	3
New.CleanUp.ReferenceOTU1036	k__Bacteria; p__Proteobacteria; c__Betaproteobacteria; o__Burkholderiales; f__Oxalobacteraceae; g__; s__	0.67	3
New.CleanUp.ReferenceOTU501	k__Bacteria; p__Actinobacteria; c__Actinobacteria; o__Actinomycetales; f__Corynebacteriaceae; g__Corynebacterium; s__	1.00	3
New.CleanUp.ReferenceOTU503	k__Bacteria; p__Proteobacteria; c__Betaproteobacteria; o__Neisseriales; f__Neisseriaceae; g__Neisseria; s__	1.00	3
New.CleanUp.ReferenceOTU502	k__Bacteria; p__Firmicutes; c__Clostridia; o__Clostridiales; f__[Tissierellaceae]; g__Anaerococcus; s__	1.00	3
New.CleanUp.ReferenceOTU504	k__Bacteria; p__Firmicutes; c__Clostridia; o__Clostridiales; f__Lachnospiraceae; g__Anaerostipes; s__	1.00	3
New.CleanUp.ReferenceOTU507	k__Bacteria; p__Bacteroidetes; c__Sphingobacteriia; o__Sphingobacteriales; f__Sphingobacteriaceae; g__Sphingobacterium; s__multivorum	1.00	3
New.CleanUp.ReferenceOTU509	k__Bacteria; p__Bacteroidetes; c__Flavobacteriia; o__Flavobacteriales; f__[Weeksellaceae]; g__; s__	1.00	1
New.CleanUp.ReferenceOTU1256	k__Bacteria; p__Actinobacteria; c__Actinobacteria; o__Actinomycetales; f__Corynebacteriaceae; g__Corynebacterium; s__	1.00	3
New.CleanUp.ReferenceOTU291	k__Bacteria; p__Firmicutes; c__Clostridia; o__Clostridiales; f__Lachnospiraceae; g__Coprococcus; s__	0.67	3
New.CleanUp.ReferenceOTU290	k__Bacteria; p__Firmicutes; c__Clostridia; o__Clostridiales; f__[Tissierellaceae]; g__Anaerococcus; s__	1.00	3
New.CleanUp.ReferenceOTU119	k__Bacteria; p__Proteobacteria; c__Betaproteobacteria; o__Neisseriales; f__Neisseriaceae; g__; s__	1.00	3
New.CleanUp.ReferenceOTU295	k__Bacteria; p__Proteobacteria; c__Gammaproteobacteria; o__Alteromonadales; f__Shewanellaceae; g__Shewanella; s__	1.00	3
New.CleanUp.ReferenceOTU294	k__Bacteria; p__Firmicutes; c__Clostridia; o__Clostridiales; f__Veillonellaceae; g__Dialister; s__	1.00	3
New.CleanUp.ReferenceOTU297	k__Bacteria; p__[Thermi]; c__Deinococci; o__Deinococcales; f__Deinococcaceae; g__Deinococcus; s__	1.00	3
New.CleanUp.ReferenceOTU922	k__Bacteria; p__Actinobacteria; c__Actinobacteria; o__Actinomycetales; f__Micrococcaceae; g__Kocuria; s__	1.00	3
New.CleanUp.ReferenceOTU112	k__Bacteria; p__Firmicutes; c__Clostridia; o__Clostridiales; f__Clostridiaceae	1.00	3
New.CleanUp.ReferenceOTU113	k__Bacteria; p__Proteobacteria; c__Gammaproteobacteria; o__Pseudomonadales; f__Moraxellaceae; g__Moraxella; s__	1.00	3
New.CleanUp.ReferenceOTU110	k__Bacteria; p__Firmicutes; c__Bacilli; o__Lactobacillales; f__Streptococcaceae; g__Streptococcus; s__	1.00	3
New.CleanUp.ReferenceOTU111	k__Bacteria; p__Firmicutes; c__Clostridia; o__Clostridiales	1.00	3
New.CleanUp.ReferenceOTU94	k__Bacteria; p__Bacteroidetes; c__Bacteroidia; o__Bacteroidales; f__Prevotellaceae; g__Prevotella; s__	1.00	1
New.CleanUp.ReferenceOTU117	k__Bacteria; p__Proteobacteria; c__Betaproteobacteria; o__Burkholderiales; f__Comamonadaceae; g__Polaromonas; s__	0.67	3
New.CleanUp.ReferenceOTU96	k__Bacteria; p__Actinobacteria; c__Coriobacteriia; o__Coriobacteriales; f__Coriobacteriaceae; g__Adlercreutzia; s__	1.00	3
New.CleanUp.ReferenceOTU115	k__Bacteria; p__Proteobacteria; c__Gammaproteobacteria; o__Pseudomonadales; f__Pseudomonadaceae; g__Pseudomonas	0.67	3
New.CleanUp.ReferenceOTU1327	k__Bacteria; p__Actinobacteria; c__Actinobacteria; o__Actinomycetales; f__Corynebacteriaceae; g__Corynebacterium; s__	1.00	3
New.CleanUp.ReferenceOTU1326	k__Bacteria; p__Firmicutes; c__Clostridia; o__Clostridiales; f__Lachnospiraceae; g__; s__	1.00	3
New.CleanUp.ReferenceOTU1496	k__Bacteria; p__Proteobacteria; c__Gammaproteobacteria; o__Enterobacteriales; f__Enterobacteriaceae; g__; s__	0.67	3
New.CleanUp.ReferenceOTU1491	k__Bacteria; p__Actinobacteria; c__Actinobacteria; o__Actinomycetales; f__Corynebacteriaceae; g__Corynebacterium; s__	0.67	3
New.CleanUp.ReferenceOTU1321	k__Bacteria; p__Firmicutes; c__Bacilli; o__Bacillales; f__Staphylococcaceae; g__Staphylococcus; s__	0.67	3
New.CleanUp.ReferenceOTU1320	k__Bacteria; p__Proteobacteria; c__Alphaproteobacteria; o__Rhizobiales; f__; g__; s__	1.00	3
New.CleanUp.ReferenceOTU1087	k__Bacteria; p__Actinobacteria; c__Actinobacteria; o__Actinomycetales; f__Propionibacteriaceae; g__Propionibacterium; s__acnes	0.67	3
New.CleanUp.ReferenceOTU1082	k__Bacteria; p__Firmicutes; c__Bacilli; o__Lactobacillales; f__Streptococcaceae; g__Streptococcus; s__	1.00	3
New.CleanUp.ReferenceOTU1498	k__Bacteria; p__Firmicutes; c__Clostridia; o__Clostridiales; f__[Tissierellaceae]; g__Parvimonas; s__	1.00	3
New.CleanUp.ReferenceOTU1329	k__Bacteria; p__Firmicutes; c__Clostridia; o__Clostridiales; f__Lachnospiraceae; g__Blautia; s__	0.67	3
New.CleanUp.ReferenceOTU1081	k__Bacteria; p__Firmicutes; c__Clostridia; o__Clostridiales; f__; g__; s__	0.67	3
New.CleanUp.ReferenceOTU1248	k__Bacteria; p__Actinobacteria; c__Actinobacteria; o__Actinomycetales; f__Micrococcaceae; g__Rothia; s__mucilaginosa	0.67	3
New.CleanUp.ReferenceOTU373	k__Bacteria; p__Firmicutes; c__Bacilli; o__Lactobacillales; f__Streptococcaceae; g__Streptococcus; s__	0.67	3
New.CleanUp.ReferenceOTU370	k__Bacteria; p__Firmicutes; c__Clostridia; o__Clostridiales; f__[Tissierellaceae]; g__Peptoniphilus; s__	1.00	3
New.CleanUp.ReferenceOTU278	k__Bacteria; p__Actinobacteria; c__Actinobacteria; o__Actinomycetales; f__Propionibacteriaceae; g__Propionibacterium; s__acnes	0.67	3
New.CleanUp.ReferenceOTU377	k__Bacteria; p__Proteobacteria; c__Alphaproteobacteria; o__Caulobacterales; f__Caulobacteraceae; g__; s__	1.00	3
New.CleanUp.ReferenceOTU273	k__Bacteria; p__Bacteroidetes; c__Bacteroidia; o__Bacteroidales; f__Porphyromonadaceae; g__Porphyromonas; s__	1.00	3
New.CleanUp.ReferenceOTU1241	k__Bacteria; p__Actinobacteria; c__Actinobacteria; o__Actinomycetales; f__Nocardiaceae; g__Rhodococcus; s__fascians	1.00	3
New.CleanUp.ReferenceOTU271	k__Bacteria; p__Bacteroidetes; c__Bacteroidia; o__Bacteroidales; f__Bacteroidaceae; g__Bacteroides; s__	1.00	3
New.CleanUp.ReferenceOTU1243	k__Bacteria; p__Proteobacteria; c__Alphaproteobacteria; o__Sphingomonadales; f__Sphingomonadaceae; g__Sphingomonas; s__	0.67	3
New.CleanUp.ReferenceOTU277	k__Bacteria; p__Proteobacteria; c__Gammaproteobacteria; o__Pasteurellales; f__Pasteurellaceae; g__Haemophilus; s__	0.67	3
New.CleanUp.ReferenceOTU276	k__Bacteria; p__Actinobacteria; c__Actinobacteria; o__Actinomycetales; f__Propionibacteriaceae; g__Propionibacterium; s__acnes	0.67	3
New.CleanUp.ReferenceOTU274	k__Bacteria; p__Firmicutes; c__Erysipelotrichi; o__Erysipelotrichales; f__Erysipelotrichaceae; g__; s__	1.00	3
New.CleanUp.ReferenceOTU719	k__Bacteria; p__Firmicutes; c__Clostridia; o__Clostridiales; f__Veillonellaceae; g__; s__	0.67	3
New.CleanUp.ReferenceOTU758	k__Bacteria; p__Firmicutes; c__Bacilli; o__Lactobacillales; f__Streptococcaceae; g__Streptococcus; s__	1.00	3
New.CleanUp.ReferenceOTU759	k__Bacteria; p__Fusobacteria; c__Fusobacteriia; o__Fusobacteriales; f__Leptotrichiaceae; g__Leptotrichia; s__	1.00	3
New.CleanUp.ReferenceOTU208	k__Bacteria; p__Firmicutes; c__Clostridia; o__Clostridiales; f__Lachnospiraceae; g__; s__	1.00	3
New.CleanUp.ReferenceOTU209	k__Bacteria; p__Firmicutes; c__Bacilli; o__Bacillales; f__Planococcaceae	0.67	3
New.CleanUp.ReferenceOTU206	k__Bacteria; p__Firmicutes; c__Clostridia; o__Clostridiales; f__Lachnospiraceae; g__; s__	0.67	3
New.CleanUp.ReferenceOTU755	k__Bacteria; p__Firmicutes; c__Clostridia; o__Clostridiales; f__Veillonellaceae; g__Veillonella; s__dispar	0.67	3
New.CleanUp.ReferenceOTU204	k__Bacteria; p__Firmicutes; c__Clostridia; o__Clostridiales; f__Lachnospiraceae; g__; s__	1.00	3
New.CleanUp.ReferenceOTU202	k__Bacteria; p__Bacteroidetes; c__[Saprospirae]; o__[Saprospirales]; f__Chitinophagaceae; g__Segetibacter; s__	1.00	3
New.CleanUp.ReferenceOTU751	k__Bacteria; p__Bacteroidetes; c__Bacteroidia; o__Bacteroidales; f__Porphyromonadaceae; g__Porphyromonas; s__	0.67	3
New.CleanUp.ReferenceOTU201	k__Bacteria; p__Actinobacteria; c__Actinobacteria; o__Actinomycetales; f__Corynebacteriaceae; g__Corynebacterium; s__	1.00	3
New.CleanUp.ReferenceOTU1143	k__Bacteria; p__Actinobacteria; c__Actinobacteria; o__Actinomycetales; f__Microbacteriaceae; g__Pseudoclavibacter	0.67	3
New.CleanUp.ReferenceOTU1142	k__Bacteria; p__Actinobacteria; c__Actinobacteria; o__Actinomycetales; f__Corynebacteriaceae; g__Corynebacterium; s__	1.00	3
New.CleanUp.ReferenceOTU976	k__Bacteria; p__Proteobacteria; c__Betaproteobacteria; o__Burkholderiales; f__Oxalobacteraceae; g__; s__	0.67	3
New.CleanUp.ReferenceOTU977	k__Bacteria; p__Actinobacteria; c__Actinobacteria; o__Actinomycetales; f__Brevibacteriaceae; g__Brevibacterium; s__	0.67	3
New.CleanUp.ReferenceOTU1147	k__Bacteria; p__Firmicutes; c__Clostridia; o__Clostridiales; f__[Tissierellaceae]; g__Finegoldia; s__	1.00	3
New.CleanUp.ReferenceOTU878	k__Bacteria; p__Bacteroidetes; c__Bacteroidia; o__Bacteroidales; f__Bacteroidaceae; g__Bacteroides; s__	0.67	3
New.CleanUp.ReferenceOTU875	k__Bacteria; p__Firmicutes; c__Bacilli; o__Bacillales; f__Staphylococcaceae; g__Staphylococcus; s__	0.67	3
New.CleanUp.ReferenceOTU874	k__Bacteria; p__Firmicutes; c__Clostridia; o__Clostridiales; f__[Tissierellaceae]; g__Anaerococcus; s__	0.67	3
New.CleanUp.ReferenceOTU1149	k__Bacteria; p__Actinobacteria; c__Actinobacteria; o__Actinomycetales; f__Nocardioidaceae; g__Nocardioides; s__	1.00	3
New.CleanUp.ReferenceOTU876	k__Bacteria; p__Firmicutes; c__Clostridia; o__Clostridiales; f__Lachnospiraceae	1.00	3
New.CleanUp.ReferenceOTU871	k__Bacteria; p__Firmicutes; c__Bacilli; o__Lactobacillales; f__Streptococcaceae; g__Streptococcus; s__	1.00	3
New.CleanUp.ReferenceOTU870	k__Bacteria; p__Proteobacteria; c__Alphaproteobacteria; o__Caulobacterales; f__Caulobacteraceae; g__; s__	0.67	3
New.CleanUp.ReferenceOTU873	k__Bacteria; p__Actinobacteria; c__Actinobacteria; o__Actinomycetales; f__Dermabacteraceae; g__Dermabacter; s__	1.00	3
New.CleanUp.ReferenceOTU917	k__Bacteria; p__Firmicutes; c__Bacilli; o__Bacillales; f__Staphylococcaceae; g__Staphylococcus; s__	0.67	3
New.CleanUp.ReferenceOTU479	k__Bacteria; p__Proteobacteria; c__Betaproteobacteria; o__Burkholderiales; f__Comamonadaceae; g__; s__	0.67	3
New.CleanUp.ReferenceOTU729	k__Bacteria; p__Proteobacteria; c__Alphaproteobacteria; o__Rickettsiales; f__mitochondria	1.00	3
New.CleanUp.ReferenceOTU473	k__Bacteria; p__Bacteroidetes; c__Bacteroidia; o__Bacteroidales; f__[Paraprevotellaceae]; g__Paraprevotella; s__	0.67	3
New.CleanUp.ReferenceOTU472	k__Bacteria; p__Firmicutes; c__Bacilli; o__Lactobacillales; f__Streptococcaceae; g__Streptococcus; s__	0.67	3
New.CleanUp.ReferenceOTU475	k__Bacteria; p__Bacteroidetes; c__Flavobacteriia; o__Flavobacteriales; f__Flavobacteriaceae; g__Flavobacterium; s__	1.00	3
New.CleanUp.ReferenceOTU477	k__Bacteria; p__Bacteroidetes; c__Bacteroidia; o__Bacteroidales; f__Porphyromonadaceae; g__Porphyromonas; s__	1.00	1
New.CleanUp.ReferenceOTU1391	k__Bacteria; p__Firmicutes; c__Bacilli; o__Gemellales; f__Gemellaceae; g__Gemella; s__	0.67	3
New.CleanUp.ReferenceOTU1394	k__Bacteria; p__Proteobacteria; c__Gammaproteobacteria; o__Pseudomonadales; f__Moraxellaceae; g__Acinetobacter; s__	0.67	3
New.CleanUp.ReferenceOTU123	k__Bacteria; p__Proteobacteria; c__Gammaproteobacteria; o__Pasteurellales; f__Pasteurellaceae; g__Aggregatibacter; s__segnis	0.67	3
New.CleanUp.ReferenceOTU850	k__Bacteria; p__Proteobacteria; c__Gammaproteobacteria; o__Enterobacteriales; f__Enterobacteriaceae; g__Erwinia; s__	0.67	3
New.CleanUp.ReferenceOTU122	k__Bacteria; p__Actinobacteria; c__Actinobacteria; o__Actinomycetales; f__Corynebacteriaceae; g__Corynebacterium; s__durum	0.67	3
New.CleanUp.ReferenceOTU653	k__Bacteria; p__Bacteroidetes; c__Bacteroidia; o__Bacteroidales; f__Porphyromonadaceae; g__Porphyromonas; s__	1.00	3
New.CleanUp.ReferenceOTU655	k__Bacteria; p__Firmicutes; c__Clostridia; o__Clostridiales; f__; g__; s__	0.67	3
New.CleanUp.ReferenceOTU126	k__Bacteria; p__Actinobacteria; c__Actinobacteria; o__Actinomycetales; f__Corynebacteriaceae; g__Corynebacterium; s__	1.00	3
New.CleanUp.ReferenceOTU623	Unassigned	1.00	1
New.CleanUp.ReferenceOTU614	k__Bacteria; p__Proteobacteria; c__Betaproteobacteria; o__Burkholderiales; f__Comamonadaceae; g__; s__	0.67	3
New.CleanUp.ReferenceOTU124	k__Bacteria; p__Firmicutes; c__Bacilli; o__Lactobacillales; f__Lactobacillaceae; g__Lactobacillus; s__	1.00	3
New.CleanUp.ReferenceOTU617	k__Bacteria; p__Firmicutes; c__Clostridia; o__Clostridiales; f__Ruminococcaceae; g__; s__	0.67	3
New.CleanUp.ReferenceOTU659	k__Bacteria; p__Bacteroidetes; c__Flavobacteriia; o__Flavobacteriales; f__Flavobacteriaceae; g__Capnocytophaga; s__ochracea	1.00	3
New.CleanUp.ReferenceOTU696	k__Bacteria; p__Actinobacteria; c__Actinobacteria; o__Actinomycetales; f__Microbacteriaceae; g__Microbacterium	0.67	3
New.CleanUp.ReferenceOTU612	k__Bacteria; p__Actinobacteria; c__Actinobacteria; o__Actinomycetales; f__Micrococcaceae; g__Rothia; s__dentocariosa	0.67	3
New.CleanUp.ReferenceOTU7	k__Bacteria; p__Proteobacteria; c__Betaproteobacteria; o__Burkholderiales; f__Comamonadaceae; g__Tepidimonas; s__	0.67	3
New.CleanUp.ReferenceOTU595	k__Bacteria; p__Fusobacteria; c__Fusobacteriia; o__Fusobacteriales; f__Fusobacteriaceae; g__Fusobacterium; s__	1.00	3
New.CleanUp.ReferenceOTU593	k__Bacteria; p__Actinobacteria; c__Actinobacteria; o__Actinomycetales; f__Propionibacteriaceae; g__Propionibacterium; s__acnes	1.00	3
New.CleanUp.ReferenceOTU155	k__Bacteria; p__Firmicutes; c__Bacilli; o__Bacillales; f__Staphylococcaceae; g__Staphylococcus; s__sciuri	0.67	3
New.CleanUp.ReferenceOTU50	k__Bacteria; p__Actinobacteria; c__Actinobacteria; o__Actinomycetales; f__Propionibacteriaceae; g__Propionibacterium; s__acnes	1.00	3
New.CleanUp.ReferenceOTU51	k__Bacteria; p__Firmicutes; c__Bacilli; o__Lactobacillales; f__Streptococcaceae; g__Streptococcus; s__	1.00	3
New.CleanUp.ReferenceOTU151	k__Bacteria; p__Bacteroidetes; c__Flavobacteriia; o__Flavobacteriales; f__[Weeksellaceae]; g__Chryseobacterium; s__	1.00	3
New.CleanUp.ReferenceOTU626	k__Bacteria; p__Proteobacteria; c__Epsilonproteobacteria; o__Campylobacterales; f__Campylobacteraceae; g__Campylobacter; s__	0.67	3
New.CleanUp.ReferenceOTU781	k__Bacteria; p__Proteobacteria; c__Alphaproteobacteria; o__Caulobacterales; f__Caulobacteraceae; g__Phenylobacterium; s__	0.67	3
New.CleanUp.ReferenceOTU159	k__Bacteria; p__Bacteroidetes; c__Bacteroidia; o__Bacteroidales; f__Bacteroidaceae; g__Bacteroides; s__	0.67	3
New.CleanUp.ReferenceOTU1043	k__Bacteria; p__Firmicutes; c__Clostridia; o__Clostridiales; f__[Tissierellaceae]; g__Anaerococcus; s__	1.00	3
New.CleanUp.ReferenceOTU1041	k__Bacteria; p__Firmicutes; c__Clostridia; o__Clostridiales; f__Lachnospiraceae	0.67	3
New.CleanUp.ReferenceOTU1047	k__Bacteria; p__Proteobacteria; c__Alphaproteobacteria; o__Rhodobacterales; f__Rhodobacteraceae	1.00	3
New.CleanUp.ReferenceOTU1045	k__Bacteria; p__Firmicutes; c__Bacilli; o__Lactobacillales; f__Carnobacteriaceae; g__Granulicatella; s__	1.00	3
New.CleanUp.ReferenceOTU1049	k__Bacteria; p__Firmicutes; c__Clostridia; o__Clostridiales; f__Peptostreptococcaceae; g__; s__	0.67	3
New.CleanUp.ReferenceOTU234	k__Bacteria; p__Actinobacteria; c__Actinobacteria; o__Actinomycetales; f__Actinomycetaceae; g__Actinomyces; s__	1.00	3
New.CleanUp.ReferenceOTU233	k__Bacteria; p__Actinobacteria; c__Actinobacteria; o__Actinomycetales; f__Nocardioidaceae; g__Nocardioides; s__	0.67	3
New.CleanUp.ReferenceOTU230	k__Bacteria; p__Proteobacteria; c__Alphaproteobacteria; o__Rhodobacterales; f__Rhodobacteraceae; g__; s__	0.67	3
New.CleanUp.ReferenceOTU1361	k__Bacteria; p__Fusobacteria; c__Fusobacteriia; o__Fusobacteriales; f__Leptotrichiaceae; g__Leptotrichia; s__	1.00	3
New.CleanUp.ReferenceOTU1360	k__Bacteria; p__Actinobacteria; c__Actinobacteria; o__Actinomycetales; f__Corynebacteriaceae; g__Corynebacterium; s__	1.00	3
New.CleanUp.ReferenceOTU411	k__Bacteria; p__Proteobacteria; c__Epsilonproteobacteria; o__Campylobacterales; f__Campylobacteraceae; g__Campylobacter; s__	1.00	3
New.CleanUp.ReferenceOTU238	k__Bacteria; p__Proteobacteria; c__Gammaproteobacteria	1.00	3
New.CleanUp.ReferenceOTU1446	k__Bacteria; p__Bacteroidetes; c__Bacteroidia; o__Bacteroidales; f__Bacteroidaceae; g__Bacteroides; s__	0.67	3
New.CleanUp.ReferenceOTU1447	k__Bacteria; p__Actinobacteria; c__Actinobacteria; o__Actinomycetales; f__Propionibacteriaceae; g__Propionibacterium; s__acnes	1.00	3
New.CleanUp.ReferenceOTU1444	k__Bacteria; p__Bacteroidetes; c__Bacteroidia; o__Bacteroidales; f__[Barnesiellaceae]; g__; s__	1.00	3
New.CleanUp.ReferenceOTU120	k__Bacteria; p__Firmicutes; c__Clostridia; o__Clostridiales; f__Lachnospiraceae	1.00	3
New.CleanUp.ReferenceOTU1442	k__Bacteria; p__Actinobacteria; c__Actinobacteria; o__Actinomycetales; f__Actinomycetaceae	0.67	3
New.CleanUp.ReferenceOTU1443	k__Bacteria; p__Firmicutes; c__Bacilli; o__Bacillales; f__Staphylococcaceae; g__Staphylococcus; s__aureus	0.67	3
New.CleanUp.ReferenceOTU1441	k__Bacteria; p__Actinobacteria; c__Actinobacteria; o__Actinomycetales; f__Corynebacteriaceae; g__Corynebacterium; s__	1.00	3
New.CleanUp.ReferenceOTU552	k__Bacteria; p__Actinobacteria; c__Actinobacteria; o__Actinomycetales; f__Corynebacteriaceae; g__Corynebacterium; s__	1.00	3
New.CleanUp.ReferenceOTU658	k__Bacteria; p__Actinobacteria; c__Actinobacteria; o__Actinomycetales; f__Micrococcaceae; g__Kocuria; s__	1.00	3
New.CleanUp.ReferenceOTU129	k__Bacteria; p__Proteobacteria; c__Alphaproteobacteria; o__Rhizobiales; f__; g__; s__	0.67	3
New.CleanUp.ReferenceOTU557	k__Bacteria; p__Proteobacteria; c__Betaproteobacteria; o__Burkholderiales; f__Oxalobacteraceae; g__; s__	0.67	3
